ماجيك  -->  Magic
ميست  -->  mist
باكبون  -->  Backbone
ديلدو  -->  dildo
تاكلينج  -->  tackling
نيفرلاند  -->  Neverland
ريسيفير  -->  receiver
غراهام  -->  Graham
بافيديو  -->  Video
تويتر  -->  Twitter
هيدروكلوريد  -->  hydrochloride
كوبالت  -->  cobalt
سيتولوجي  -->  Cytology
كومبراتيف  -->  Comparative
هايدروكسيد  -->  hydroxide
هوكي  -->  hockey
روتين  -->  Routine
تاان  -->  tan
نيكولودين  -->  Nickelodeon
الوكس  -->  lux
سستر  -->  Sister
أنسولين  -->  Insulin
الأبارتهايد  -->  Apartheid
دويتوا  -->  duet
أرييل  -->  Ariel
ديفينتلي  -->  Definitely
اروماتيك  -->  Aromatic
الديفيلوبر  -->  developer
الهيبريد  -->  Hybrid
سربرايس  -->  Surprise
التريتيوم  -->  tritium
الريست  -->  Rest
البروجيريا  -->  Progeria
برافووو  -->  Bravo
بولوجيه  -->  biology
وردبلاي  -->  wordplay
اللودو  -->  ludo
الباركينج  -->  parking
ووركينج  -->  working
ماندالا  -->  mandala
كيرنل  -->  kernel
سبورتنح  -->  sporting
جينراتور  -->  Generator
مينتال  -->  mental
الماينتاينر  -->  maintainer
بوتيفوول  -->  Beautiful
ميداليه  -->  Medal
ووندرينج  -->  Wondering
سيتزن  -->  Citizen
البوكسينج  -->  boxing
كونفيرميد  -->  Confirmed
ماكسييماال  -->  Maximal
سبيسيفك  -->  SPECIFIC
مونيمونتال  -->  Monumental
بدلتا  -->  delta
يإنجوي  -->  enjoy
جراند  -->  Grand
ابسلولتلي  -->  Absolutely
راديولوجي  -->  Radiology
ريتاردد  -->  retarded
ديلر  -->  Dealer
ستريوتيب  -->  Stereotype
بروتستنتية  -->  Protestant
السنتروم  -->  centrum
كماركتينج  -->  Marketing
نيون  -->  neon
الجوريذم  -->  Algorithm
تتوريال  -->  tutorial
المسترال  -->  Mistral
استيرلينج  -->  sterling
سبووني  -->  leave me
مالمليون  -->  million
تايلنت  -->  Talent
المومينتم  -->  Momentum
ميستريي  -->  Mystery
السيمنار  -->  Seminar
ديليفرى  -->  delivery
ترانسفورم  -->  transform
وسيجنال  -->  Signal
فمينيست  -->  feminist
توليب  -->  tulip
توديى  -->  today
الجاليوري  -->  Gallery
لفليكس  -->  flex
سنترالا  -->  Central
ديجتال  -->  digital
هيستامينك  -->  histamine
التربون  -->  Tarpon
براجماتيين  -->  pragmatics
بورتريه  -->  portrait
مينيرال  -->  Mineral
سباركيل  -->  Sparkle
افيلابل  -->  available
الترينينج  -->  training
بيوتيريك  -->  butyric
فينانسييل  -->  Financial
بريسينتيشن  -->  Presentation
هورينج  -->  Whoring
بيريدوكسين  -->  pyridoxine
راندوملي  -->  Randomly
البيبليوجرافي  -->  Bibliography
الماييسترو  -->  maestro
موفينج  -->  moving
برنزية  -->  bronze
ستيرنج  -->  Steering
بوينت  -->  point
البالون  -->  balloon
الراديولوچي  -->  radiology
ايدولوجية  -->  ideology
تيستسي  -->  tasty
فااينال  -->  final
بايكينج  -->  Baking
كالسيوم  -->  Calcium
كفانتازي  -->  Fantasy
دينايال  -->  denial
تارتيج  -->  tart
رومنسيني  -->  Romance
نيجاتيڤ  -->  negative
برينسيس  -->  Princess
بيرسويت  -->  Pursuit
دراماتيك  -->  dramatic
دوبليكس  -->  Duplex
فيوريوس  -->  Furious
بيتززاا  -->  pizza
الموديلنج  -->  Modeling
بروديوسر  -->  Producer
فيدبااك  -->  Feedback
جيبونة  -->  jupe
ديسسكارد  -->  Discard
اينتومولوجي  -->  Entomology
ترييند  -->  Trend
هوسبيس  -->  hospice
فولوو  -->  follow
ميلتري  -->  Military
ستروكر  -->  Stroker
اتيرنتي  -->  Eternity
كرياتيفيتى  -->  Creativity
السموكنج  -->  smoking
مونولوجست  -->  monologist
سوفونير  -->  Souvenir
برووفيل  -->  Profile
نيكتارين  -->  nectarine
ليبراليا  -->  liberal
سبيسياال  -->  special
سميولاتور  -->  Simulator
فيرتيلايزر  -->  Fertilizer
البانورما  -->  panorama
البارافين  -->  paraffin
ترانسيفير  -->  transfer
انونمس  -->  Anonymous
اوكرديون  -->  accordion
التورتيلا  -->  tortilla
جيرمني  -->  German
ستيريوتايب  -->  Stereotype
لمارينا  -->  Marina
ميدالية  -->  Medal
اييرون  -->  Iron
فايرر  -->  firer
الاوكسيتوسين  -->  oxytocin
الأبنورمال  -->  Abnormal
فيلتر  -->  filter
ريموف  -->  remove
بانانا  -->  Banana
فورمات  -->  Format
أبارتهيد  -->  apartheid
الجالاكسيز  -->  Galaxy
ساتليت  -->  Satellite
وسترونج  -->  strong
انتريست  -->  interest
فاليو  -->  value
بلكيلو  -->  kilo
برولاكتين  -->  prolactin
بروباجندة  -->  Propaganda
ترايدنت  -->  trident
هستولوجي  -->  histology
سلفوريك  -->  sulfuric
جيمبلاي  -->  Gameplay
إسبراي  -->  spray
بانجو  -->  bango
نووبل  -->  Noble
مينتاليتي  -->  mentality
سبيورت  -->  sport
ميتل  -->  Metal
سيتيزنس  -->  Citizen
كونتينت  -->  Content
بروفايل  -->  Profile
فورجيت  -->  Forget
ليڨينج  -->  Living
سويشال  -->  social
هارتبريكنج  -->  Heartbreaking
بريديج  -->  Bridge
سكيورتي  -->  Security
البريميوم  -->  Premium
باليرينا  -->  ballerina
ماسكيولينيتي  -->  Masculinity
امبير  -->  Ampere
السولو  -->  solo
أيديولوجيست  -->  ideologist
زووم  -->  Zoom
بوتينشال  -->  Potential
سترنج  -->  String
دونكي  -->  donkey
فورس  -->  force
سالاط  -->  salad
داينامايت  -->  dynamite
اندرستاندنج  -->  Understanding
سااموراي  -->  samurai
الباندا  -->  panda
فاميليار  -->  familiar
بوبكورن  -->  popcorn
ريسبكيت  -->  Respect
تاكين  -->  takin
جاينر  -->  Gainer
السوبيريورتي  -->  Superiority
جونيور  -->  Junior
هاندميد  -->  handmade
التوراه  -->  Torah
تيليفون  -->  Telephone
فلاج  -->  Flag
برافو  -->  Bravo
فورما  -->  form
إيفرجرين  -->  evergreen
امونج  -->  among
براوفوا  -->  Bravo
استررونج  -->  strong
تريينج  -->  training
البروتستانتى  -->  Protestant
البلاكبيري  -->  Blackberry
الفيكسيد  -->  Fixed
تسونامي  -->  tsunami
ريللى  -->  Really
ريلايتابل  -->  relatable
الميتابوليزم  -->  Metabolism
اوريجناال  -->  original
فاكتوري  -->  Factory
وترملون  -->  Watermelon
جيولوجي  -->  geology
اتلانتيك  -->  Atlantic
هيدروچين  -->  hydrogen
اوتوماتيكلي  -->  Automatically
ااسمارت  -->  smart
اوفرلي  -->  Overly
ديكتاتور  -->  Dictator
ديرماا  -->  Derma
إليجانس  -->  Elegance
اوتفيت  -->  outfit
زيررو  -->  Zero
جينيريتور  -->  Generator
بريليانت  -->  Brilliant
ورركس  -->  works
ديلفيرى  -->  Delivery
هوليداى  -->  holiday
بالميلودراما  -->  melodrama
الهيدروجيولوجية  -->  hydrogeological
رينبوو  -->  Rainbow
بورسيلين  -->  Porcelain
بارتنر  -->  partner
اورنج  -->  orange
هااكينج  -->  Hacking
راندومنيس  -->  Randomness
أسبستوس  -->  asbestos
ريتاردت  -->  retarded
فروم  -->  from
اسيمبليي  -->  Assembly
بوكمارك  -->  Bookmark
دياجرام  -->  Diagram
مونتاجية  -->  montage
استرونجج  -->  strong
هاوسينج  -->  housing
انيرجي  -->  Energy
سبييد  -->  speed
ايفينينج  -->  Evening
برونزيه  -->  Bronze
بولينج  -->  bowling
هيدروكسيل  -->  hydroxyl
أستراتجية  -->  strategic
باكوورد  -->  backword
بسبويلر  -->  spoiler
اوتو  -->  Auto
ميجابارسيك  -->  Megaparsec
بلوكنج  -->  Blocking
التمبليت  -->  Templet
ستييرينج  -->  Steering
الساونا  -->  sauna
يارد  -->  yard
بوميجرانت  -->  pomegranate
فليرت  -->  flirt
إسبستوس  -->  asbestos
اسبووت  -->  Spot
فرست  -->  verst
راديولوجى  -->  radiology
ألكيلو  -->  kilo
بلازما  -->  plasma
سينتروم  -->  Centrum
موررننج  -->  Morning
براديس  -->  Paradise
الريسيت  -->  Receipt
اجين  -->  again
بريفورمنس  -->  performance
الهيكسا  -->  Hexa
وراسبيري  -->  raspberry
ريزيستانس  -->  Resistance
اغابي  -->  agape
استوري  -->  story
كاميرا  -->  Camera
بيرفورمانس  -->  Performance
مونيكر  -->  moniker
بروفيسور  -->  Professor
بريفكس  -->  prefix
كونتراست  -->  Contrast
ترافيلر  -->  Traveler
فيلمم  -->  film
سترليني  -->  sterling
سبرينكل  -->  Sprinkle
فايندر  -->  Finder
اادرينالين  -->  adrenaline
تريسيكل  -->  motorcycle
نوميركال  -->  numerical
برستيج  -->  Prestige
هاندماد  -->  handmade
درون  -->  Drone
فاوند  -->  found
الفانتاستيك  -->  Fantastic
استاتيس  -->  status
انسوليين  -->  Insulin
الماركتيينج  -->  Marketing
بالأناتومي  -->  Anatomy
امبريلا  -->  Umbrella
سيڤين  -->  Seven
ايديتور  -->  editor
بروتين  -->  protein
أستيجماتيزم  -->  astigmatism
هردين  -->  harden
جورجويوس  -->  Gorgeous
موبيل  -->  mobile
البروستانت  -->  Protestant
بروبيجاندا  -->  propaganda
ترايننج  -->  training
ميدسينال  -->  medicinal
سيترين  -->  citrine
رومانسيه  -->  romance
سوكيت  -->  Socket
ألارم  -->  Alarm
سبونسور  -->  Sponsor
سيليكون  -->  silicon
ادابتر  -->  adapter
تالانتليس  -->  talentless
كونترول  -->  control
استور  -->  store
سباسز  -->  spaces
انفورميد  -->  Informed
سوبرماان  -->  Superman
ريسبونس  -->  response
فورقيت  -->  Forget
الهايدروجين  -->  hydrogen
توست  -->  toast
كيلوا  -->  kilo
ريبورت  -->  Report
اكسباند  -->  Expand
أوريجنال  -->  Original
باربيكان  -->  Barbican
المتروبوليتان  -->  metropolitan
توربينة  -->  turbine
هيبوكلوريت  -->  hypochlorite
فيستڤال  -->  Festival
الفورمالدهيد  -->  formaldehyde
رادياتير  -->  radiator
بالارينا  -->  ballerina
ديابيتس  -->  Diabetes
تريج  -->  Trig
ترانسفورمر  -->  transformer
البولينج  -->  bowling
تارجيت  -->  target
سمبوزيوم  -->  Symposium
ايرلي  -->  early
ديالوجا  -->  Dialogue
بالاندرويد  -->  Android
اوتوماتيكى  -->  automatic
سناب  -->  snap
ادميرر  -->  Admirer
باسورد  -->  password
فورينر  -->  foreigner
إفينينج  -->  Evening
كريتيريا  -->  criteria
اينفينيتي  -->  Infinity
نيكست  -->  Next
كراتيه  -->  karate
توميتو  -->  tomato
مونتاجا  -->  montage
كاكي  -->  khaki
لانيميا  -->  Anemia
الموستانج  -->  mustang
بلانديش  -->  Blandish
ميراج  -->  Mirage
الادفانس  -->  Advance
سيسزون  -->  season
وبيرفيوم  -->  Perfume
انسبيرد  -->  Inspired
رابيد  -->  Rapid
ساموراي  -->  samurai
رفلكس  -->  reflex
اوتومااتيك  -->  automatic
هيبوكالسيميا  -->  Hypocalcemia
سايلنت  -->  Silent
نيترونى  -->  neutron
بروتوكولي  -->  protocol
بهستريا  -->  hysteria
الالبوم  -->  album
فارييتى  -->  Variety
انانيموس  -->  Anonymous
مانجوا  -->  mango
اسيد  -->  acid
فولتاج  -->  Voltage
سوســيولوجيا  -->  Sociology
ريفيل  -->  Revel
اوتيزم  -->  autism
ديبريسد  -->  depressed
سوند  -->  sound
نوستليجيا  -->  Nostalgia
فلييت  -->  Fleet
هاسكي  -->  husky
دوكاتو  -->  ducato
ايساغوجي  -->  Isagoge   1
الكاراتيه  -->  karate
فلامنغو  -->  flamingo
الأيديولوجية  -->  ideology
ماريونت  -->  marionette
البيوتيفول  -->  Beautiful
موديرااتور  -->  moderator
لوجيكال  -->  Logical
فيولين  -->  Violin
ترمنال  -->  terminal
بريميام  -->  Premium
فرابيه  -->  frappe
زيبرا  -->  zebra
برستيجه  -->  Prestige
اوونلي  -->  only
سبورتى  -->  sporty
اوبتيميز  -->  Optimize
اسبورتنج  -->  sporting
كيتن  -->  kitten
بستوديو  -->  studio
بوليسية  -->  police
ألبوم  -->  album
ماناجمينت  -->  management
كانجارو  -->  kangaroo
راندم  -->  Random
تااكسي  -->  taxi
فيروس  -->  virus
كربوناتي  -->  carbonate
استايلي  -->  Style
بيرسونالي  -->  Personally
تيستوستيرون  -->  Testosterone
تويتتر  -->  Twitter
أستراتيجين  -->  strategic
توكسوبلزموزيس  -->  Toxoplasmosis
بيبليوجرافي  -->  bibliography
الميكروفيلم  -->  microfilm
فورميولا  -->  Formula
بوسيتيفف  -->  Positive
تايمنج  -->  Timing
مديديا  -->  media
ريترن  -->  return
المونوجرام  -->  monogram
السستروم  -->  sistrum
ماكينج  -->  making
فيلينج  -->  Feeling
ساسبينديد  -->  suspended
المينتاليتى  -->  Mentality
ايجينت  -->  Agent
السوبيريور  -->  Superior
بيتشفورك  -->  Pitchfork
أندرويد  -->  Android
اوريچينال  -->  original
ليمون  -->  lemon
فيلهارموني  -->  Philharmonic
استارر  -->  star
الريستينج  -->  resting
سمارت  -->  Smart
فودكا  -->  Vodka
سينجيولير  -->  Cingular
ميديسينال  -->  Medicinal
سنترال  -->  Central
ترانزيتي  -->  transit
الفولفيلمنت  -->  Fulfillment
ارتيسيت  -->  Artist
هومليس  -->  homeless
تريندج  -->  trending
إسبايسي  -->  Spicy
البريكينج  -->  breaking
كونتنينتل  -->  Continental
إيكسايتينج  -->  Exciting
نورمالل  -->  normal
الراديولوجى  -->  radiology
انيمياا  -->  anemia
ليموناً  -->  lemon
بيدياتريك  -->  Pediatric
تيلقرام  -->  Telegram
روبوت  -->  robot
اوبنينج  -->  Opening
لونج  -->  long
اندرايدچ  -->  Underage
البراجماتيكس  -->  pragmatics
البروجيستيرون  -->  progesterone
سوسايتي  -->  Society
ههان  -->  han
البينكي  -->  Pinky
ليرنيج  -->  learning
الترامواي  -->  tramway
ووندر  -->  Wonder
امفيتامين  -->  amphetamine
ديفولبمينت  -->  development
هيستولوجي  -->  histology
برنسيسسه  -->  Princess
بيرسونالى  -->  Personally
ميكرو  -->  micro
بوسيبل  -->  Possibleq
سينسور  -->  sensor
تلجرام  -->  telegram
الجيرياتريك  -->  Geriatric
كانفاس  -->  canvas
وأناتومي  -->  Anatomy
ماركتينح  -->  Marketing
فايناال  -->  final
سترونج  -->  strong
ايربلين  -->  Airplane
استيراتيجية  -->  strategy
سلييب  -->  sleep
باسبورك  -->  Passport
انديكس  -->  Index
بهيبر  -->  Hyper
التيفولي  -->  tivoli
بيرسينق  -->  piercing
بودنج  -->  pudding
نوتفي  -->  Notify
فيمينيسم  -->  feminism
الوورلد  -->  world
هاڤين  -->  Heaven
باكويرد  -->  Backward
فيكس  -->  Fix
استراتيجيه  -->  strategy
كانجرو  -->  kangaroo
ترمنولوچي  -->  Terminology
لبتون  -->  lepton
دراماتيكى  -->  dramatic
فرابتشينو  -->  Frappuccino
فاندوم  -->  fandom
يونيتيد  -->  United
ويتنج  -->  Waiting
سولد  -->  sold
الترايلر  -->  trailer
باندا  -->  panda
ڨودكا  -->  vodka
ڨيجيتيريان  -->  Vegetarian
سترونشيوم  -->  strontium
ديفاند  -->  Defined
بيوند  -->  Beyond
مديسينال  -->  medicinal
ايفنت  -->  Event
أنترناشيونال  -->  International
المونتاجي  -->  montage
ديليفري  -->  Delivery
فليكس  -->  flex
اندريود  -->  Android
مايكينج  -->  making
توتال  -->  Total
ريجيستريشن  -->  Registry
نيورولوجيكال  -->  Neurological
جينيروتر  -->  Generator
مورنينجز  -->  Mornings
برسون  -->  Person
ستيريوتيب  -->  Stereotype
المينيوم  -->  aluminum
ايفرمور  -->  Evermore
أنثروبولوجي  -->  anthropology
سينماتوجرافي  -->  Cinematography
ريدر  -->  Reader
سويت  -->  Sweet
بيبي  -->  Baby
ستيرلينج  -->  Sterling
بورنزيه  -->  bronze
سناك  -->  Snack
ريسورت  -->  Resort
سنستيف  -->  Sensitive
تهاندل  -->  handle
فلكلورية  -->  folklore
بارامتر  -->  parameter
برتفوليو  -->  portfolio
ساركوما  -->  sarcoma
سنسيتف  -->  Sensitive
واتس اب  -->  whatsApp
كرياتيفيتي  -->  Creativity
سلاد  -->  salad
بلوم  -->  Bloom
افترلايف  -->  Afterlife
اوتينج  -->  outing
باركنج  -->  Parking
ريبروت  -->  Report
بروميس  -->  Promise
ترينيج  -->  training
سيروب  -->  Syrup
سيتر  -->  sitter
مونتاج  -->  montage
هيدرولوجيا  -->  hydrology
بلاكبورد  -->  blackboard
كراتية  -->  Karate
ماركتنينج  -->  Marketing
أنيميا  -->  anemia
بايولوجى  -->  Biology
ملاريا  -->  malaria
راديوو  -->  radio
كاستينج  -->  casting
باسيفيك  -->  Pacific
ينيفورم  -->  Uniform
لانجيري  -->  Lingerie
SPACE  -->  hادفانسيد   Advanced
تيستيسترون  -->  Testosterone
بينج  -->  ping
ميتريال  -->  Material
ميجالومانيا  -->  Megalomania
ريليت  -->  relate
لوچيستية  -->  logistic
ميلانكوليا  -->  melancholia
بنزيدين  -->  benzidine
المتادور  -->  Matador
بويتيفول  -->  Beautiful
هوستل  -->  hostel
جرام  -->  gram
جيست  -->  guest
ستيديوم  -->  stadium
اوتستاندنج  -->  Outstanding
كارتوون  -->  cartoon
نايسلي  -->  Nicely
ترمنلوجي  -->  Terminology
ترانزيت  -->  Transit
بروبوغاندا  -->  propaganda
ميثودولوجية  -->  Methodology
بورترايت  -->  Portrait
انيميا  -->  anemia
ترليون  -->  trillion
لويالتي  -->  loyalty
منتالي  -->  mentally
ديسكريت  -->  Discrete
ترند  -->  trend
دياثيرمي  -->  diathermy
رومانسيةة  -->  romance
بروليتاريا  -->  proletariat
جيواستراتيجيا  -->  geostrategy
كونفيرتور  -->  Convertor
فرونتال  -->  Frontal
سنجل  -->  single
بارتينر  -->  partner
ليكويد  -->  Liquid
أفورجيت  -->  Forget
ايرون  -->  Iron
هاندبول  -->  handball
مارفيل  -->  Marvel
تأكسي  -->  taxi
سندروم  -->  Syndrome
إيكونومي  -->  Economy
راديكال  -->  Radical
سيميستر  -->  semester
ديناصور  -->  dinosaur
جاكيت  -->  jacket
جيرل  -->  girl
فلورايد  -->  fluoride
جروب  -->  group
ابراكدابرا  -->  abracadabra
إستراتيجي  -->  strategic
فالنتين  -->  Valentine
ديفندر  -->  Defender
الفيمينيسم  -->  feminism
دريم  -->  Dream
التراجيديه  -->  Tragedy
فانكي  -->  funky
ليستة  -->  List
جورناليزم  -->  Journalism
ارتتيست  -->  artist
سيكشوالايز  -->  Sexualize
إكسبيرت  -->  expert
سبورتج  -->  Sporting
اوتومبيل  -->  Automobile
ألومنيوم  -->  Aluminium
تيرميناتور  -->  terminator
فيدييو  -->  video
فالينتاين  -->  Valentine
جالاكسي  -->  Galaxy
مودلينج  -->  Modeling
بروباغاندا  -->  propaganda
بروفيل  -->  Profile
إلبوم  -->  album
افورت  -->  over
فانيليا  -->  vanilla
ديناميكي  -->  dynamic
نورماال  -->  normal
ديستانس  -->  Distance
دايجيستف  -->  Digestive
جالكسي  -->  Galaxy
ديماجوجية  -->  demagoguery
ديستراكتد  -->  distracted
أستراتيجيت  -->  strategy
الفريندلي  -->  Friendly
جنتل  -->  gentle
البريمير  -->  Premier
استروونج  -->  strong
فولووينج  -->  following
انداستريال  -->  Industrial
درامتيك  -->  Dramatic
بوتستراب  -->  bootstrap
سانت  -->  Saint
وندرلاند  -->  Wonderland
البروجستيرون  -->  progesterone
الاوبتيميسم  -->  optimism
سيمبوليك  -->  symbolic
ابثولوتلي  -->  Absolutely
دياجنوستك  -->  Diagnostic
ديكتاتورا  -->  dictator
ترمنولوجى  -->  Terminology
براڨو  -->  Bravo
هيدروجينية  -->  hydrogen
بارتي  -->  party
البوردينج  -->  boarding
ديبلوماسية  -->  Diplomacy
فيدرالى  -->  Federal
تلجيرام  -->  Telegram
كلادينج  -->  Cladding
أستوديو  -->  studio
الدبلوما  -->  Diploma
أنفستور  -->  Investor
تريلير  -->  Trailer
بوبولار  -->  popular
ستريبر  -->  striper
سيرفو  -->  servo
سيترونيلا  -->  citronella
بكنج  -->  Baking
ماركر  -->  Marker
المومنيوم  -->  aluminum
الماسكولينيتي  -->  Masculinity
فايميلي  -->  family
موسيقية  -->  music
موسيقى  -->  music
اوتماتيك  -->  automatic
سلايد  -->  Slide
ايماجين  -->  Imagine
ميموري  -->  memory
ديجنتي  -->  Dignity
يونيفيرستي  -->  University
كونتينينتال  -->  Continental
نفيجاتور  -->  Navigator
ارتييست  -->  ARTIST
جيرونتولوجى  -->  gerontology
اسيمبلي  -->  assembly
انترسبتور  -->  Interceptor
ريتم  -->  Rhythm
كاراميل  -->  Caramel
سبرينج  -->  Spring
ميديآ  -->  media
إندبيندنت  -->  Independent
مينينج  -->  Mining
سيرافيم  -->  seraphim
توستر  -->  toaster
كلارينت  -->  clarinet
ليترالى  -->  literal
بيرفم  -->  perfume
ابسلوتي  -->  Absolute
دينامو  -->  dynamo
وماستربيس  -->  Masterpiece
استادیوم  -->  stadium
وبيدرو  -->  Pedro
الآمين  -->  Amen
واتر  -->  Water
أسبليت  -->  Split
بومبو  -->  Bombo
سنيورر  -->  Senior
وندرفل  -->  wonderful
اسبيشاليست  -->  Specialist
اوه  -->  oh
ويركس  -->  works
جادجمينت  -->  Judgment
الماريونيت  -->  marionette
بريستيج  -->  Prestige
أونكس  -->  Onyx
لاسيه  -->  lacy
بنيفيتس  -->  Benefit
انترستيلار  -->  Interstellar
الهولدينج  -->  holding
تراڤيلينج  -->  Traveling
إستراتيجية  -->  strategy
انديبنديت  -->  Independent
ايمبورتانت  -->  important
كيلوواط  -->  kilowatt
ويركينج  -->  working
جيوبوليتيكال  -->  Geopolitical
فلورانس  -->  Florence
لوغوس  -->  Logos
كونفيرسيشن  -->  Conversation
النوستالجياا  -->  nostalgia
ماكينغ  -->  making
تریند  -->  trend
البليندر  -->  blender
الترانسليتور  -->  Translator
توتالة  -->  Total
سيستيم  -->  system
اوكسوجين  -->  Oxygen
اافورماتيف  -->  Afformative
سمبلكس  -->  simplex
دايفنج  -->  Diving
يسترداي  -->  Yesterday
إنجوي  -->  enjoy
الساليسيليك  -->  salicylic
جيتاريست  -->  Guitarist
ليڤيل  -->  Level
موستارد  -->  mustard
ديبارتمينت  -->  Department
برينتر  -->  Printer
ڤيتامين  -->  vitamin
توكسيستى  -->  Toxicity
هاللو  -->  Hello
أدفيسوري  -->  advisory
اوفيردرايف  -->  Overdrive
إكسبلور  -->  explore
روكيت  -->  Rocket
سيانيد  -->  cyanide
ساتان  -->  satin
فانتاسي  -->  Fantasy
ريالتتي  -->  Reality
فايبريتور  -->  Vibrator
الديسبلي  -->  DISPLAY
ديليوشن  -->  Dilution
ميتينج  -->  meeting
الهيباتولوجي  -->  Hematology
الاوتومبيل  -->  Automobile
استراتجي  -->  strategic
هستيريا  -->  hysteria
استيروتيبنج  -->  Stereotyping
كواليتي  -->  Quality
آلارم  -->  Alarm
هامبورجر  -->  hamburger
ماركتنج  -->  Marketing
هيسرتيا  -->  Hysteria
التوكسيسيتي  -->  toxicity
ايدينتيتي  -->  Identity
ميكرون  -->  micron
صوديوم  -->  sodium
باكينج  -->  Baking
رومانتيكي  -->  romantic
ميترولوجي  -->  metrology
تايتل  -->  title
فيرولوجي  -->  virology
تواليت  -->  toilet
كليبتومانيا  -->  kleptomania
بهستيرياآ  -->  hysteria
الومينيوم  -->  aluminum
ديفنس  -->  Defense
سيليكات  -->  silicate
سبيلنج  -->  Spelling
رستارت  -->  restart
الديودرانت  -->  deodorant
تايبوجرافي  -->  typography
سيليبرتي  -->  Celebrity
سيجماتيزم  -->  sigmatism
ماتيريال  -->  Material
فيتامين  -->  vitamin
اسبايسي  -->  Spicy
هايبومنيا  -->  Hypomania
ڤيديو  -->  video
سينترال  -->  Central
رسيبكت  -->  respect
لوجيك  -->  Logic
فرونت  -->  front
جيولوجين  -->  geologians
الهيباتولوچي  -->  Hepatology
النيتوورك  -->  Network
الماركيتنج  -->  Marketing
برستيجي  -->  My prestige
ريستارتت  -->  Restart
بروبجندا  -->  propaganda
سكيليتون  -->  Skeleton
نيكيلودين  -->  Nickelodeon
سيجنال  -->  Signal
درييم  -->  dream
اوفرسايزيد  -->  Oversized
ماريونييت  -->  marionette
استريو  -->  stereo
ڨيروس  -->  virus
الابنورمال  -->  Abnormal
تورنيدو  -->  tornado
ستريس  -->  STRESS
فيللا  -->  villa
ترينر  -->  Trainer
باكيت  -->  packet
راستر  -->  restart
سكريبت  -->  script
راندوم  -->  Random
الجاستروانتريتيس  -->  Gastroenteritis
جورناليست  -->  Journalist
ريتورت  -->  retort
ليفينج  -->  Living
ريكورد  -->  record
الابيديرميس  -->  Epidermis
بروبابلتى  -->  Probability
جرووب  -->  group
جينوم  -->  genome
سيــناريو  -->  scenario
سبيدر  -->  spider
هيدرو  -->  hydro
ووركشوب  -->  Workshop
ڤارييتي  -->  Variety
فرندلي  -->  Friendly
كومبلكس  -->  complex
ادورابل  -->  adorable
ريسترت  -->  Restart
فلامنجو  -->  flamingo
فوود  -->  Food
چينيرالي  -->  General
موبآيلي  -->  mobile
نستالجيا  -->  Nostalgia
هيدسيت  -->  headset
مانجو  -->  mango
جيولوجيا  -->  geology
ليمونادا  -->  lemonade
ليموناده  -->  lemonade
ڤانيللا  -->  Vanilla
برينتد  -->  Printed
جيرلل  -->  girl
إنترفال  -->  Interval
ألومينوم  -->  aluminum
ريفرينس  -->  Reference
جوديشال  -->  Judicial
سوسيال  -->  social
السيريال  -->  serial
برايسد  -->  Priced
فوويس  -->  voice
لوجيستك  -->  logistic
انوركسيا  -->  Anorexia
باسوورده  -->  password
سايينج  -->  saying
كليلو  -->  kilo
السيتوباثولوجي  -->  Cytopathology
رايتنج  -->  rating
بروبلم  -->  problem
مورنينچ  -->  Morning
الأوتومبيل  -->  Automobile
ستانليس  -->  Stainless
اندورويد  -->  Android
الهاندباج  -->  handbag
جليتر  -->  glitter
بيبر  -->  Paper
ايديولوجيا  -->  ideology
جينيريك  -->  Generic
كوميتمينت  -->  Commitment
كاردهولدر  -->  Cardholder
بارانويد  -->  Paranoid
ڤيرتشوال  -->  Virtual
باردايس  -->  Paradise
رييلااكس  -->  RELAX
اسباركل  -->  Sparkle
بانورامى  -->  panoramic
سيكينج  -->  Seeking
هامبروجر  -->  Hamburger
ماركيتنج  -->  Marketing
نيتروجين  -->  Nitrogen
هيدروجينيه  -->  hydrogenic
لوفلي  -->  Lovely
ليتل  -->  Little
ديناسور  -->  dinosaur
البرولاكتين  -->  prolactin
ريبلاى  -->  Reply
ڤيسيولوجي  -->  physiology
أنيرجي  -->  Energy
جيلوجيا  -->  geology
داييتت  -->  Diet
فوريڤير  -->  Forever
دبولوماسية  -->  Diplomacy
اوكسيجين  -->  Oxygen
هارڤيست  -->  Harvest
هيباتوما  -->  Hepatoma
ريكوردنج  -->  Recording
كومبوننت  -->  Component
الأوتوموبيل  -->  Automobile
هيسترويا  -->  hysteria
دينامكس  -->  dynamics
اوريجنل  -->  original
مونولوج  -->  monologue
هيبوثلاموس  -->  Hypothalamus
انترناسيونال  -->  International
صالون  -->  salon
بارانورمال  -->  Paranormal
البروجريس  -->  Progress
سبسيفيك  -->  Specific
ايرجنت  -->  Argent
بلاستيكة  -->  plastic
ماركيتينج  -->  Marketing
بروكن  -->  Broken
تاكسي  -->  taxi
سيناريوا  -->  scenario
ميكروبيولوجيست  -->  microbiologist
دنتال  -->  Dental
چونيور  -->  Junior
استجماتزم  -->  astigmatism
لينجوستيك  -->  Linguistic
ديجيتال  -->  digital
تريليونية  -->  trillion
ايجو  -->  Ego
سبرنج  -->  spring
اتوموبيل  -->  Automobile
ماينينج  -->  Mining
الريبورتر  -->  reporter
برافوو  -->  Bravo
تيمبرلاند  -->  Timberland
الفليرتينج  -->  flirting
بروسيزس  -->  prosthesis
الجلوبال  -->  Global
الأكسيتوسين  -->  oxytocin
أوميكرون  -->  Omicron
اوتونوميك  -->  Autonomic
بيروكسيد  -->  peroxide
الراديوم  -->  radium
فايبرويد  -->  fibroid
ديسبلاي  -->  Display
ويتر  -->  Waiter
ريستارط  -->  Restart
سبايكي  -->  Spiky
سالمونيلا  -->  salmonella
انتيبيوتك  -->  Antibiotic
ردارا  -->  radar
دراماتورج  -->  Dramaturgy
فورمل  -->  Formal
ريميمبر  -->  Remember
كونتيننتال  -->  Continental
بريفيوم  -->  Prefium
ملينيوم  -->  Millennium
وندرفول  -->  Wonderful
أكسبورت  -->  Export
سيمبول  -->  symbol
البانانا  -->  Banana
الأنجري  -->  Angry
كوبرا  -->  Cobra
المايسترو  -->  maestro
توتاالي  -->  Totally
واركرافت  -->  warcraft
استيرلنج  -->  sterling
بورترية  -->  portrait
الموديريتور  -->  moderator
بماينس  -->  Minus
رافيولي  -->  ravioli
بيبتدي   بيبتدي  -->  
البلاكبورد  -->  Blackboard
دليفري  -->  Delivery
تمبرلاند  -->  Timberland
دريس  -->  Dress
سبارك  -->  Spark
سيناريوه  -->  scenario
فلات  -->  flat
ماتينيه  -->  matinee
ميلليجرام  -->  milligram
فيكسد  -->  Fixed
باتمان  -->  batman
بروليه  -->  brulee
ميددل  -->  middle
الفولكلور  -->  folklore
الانثروبولوجي  -->  anthropology
البوليسترين  -->  polystyrene
الديرماتولجي  -->  Dermatology
چاجوار  -->  Jaguar
فيت  -->  Fit
كونفيرتبل  -->  Convertible
فانتاسايز  -->  fantasy
ابسولوتلى  -->  Absolutely
وسولديرر  -->  soldier
سيلندر  -->  cylinder
استارت  -->  start
الهيدروجين  -->  hydrogen
مانجة  -->  mango
ابستمولوجي  -->  epistemology
براافوا  -->  Bravo
وودسايد  -->  Woodside
جيولوجيه  -->  geology
التوربيد  -->  torpedo
ريلود  -->  Reload
بيبليوجرافيا  -->  Bibliography
فيجتريان  -->  Vegetarian
اسفيكسيا  -->  Asphyxia
إيفنت  -->  Event
سالاد  -->  Salad
جيلاتيين  -->  gelatin
النيتريت  -->  nitrite
اناليتيكال  -->  Analytical
أبسوليوتلي  -->  Absolutely
بيرذداي  -->  birthday
فورايفير  -->  Forever
مودل  -->  model
ابسنت  -->  Absent
ريست  -->  rest
استراتيجية  -->  strategic
جراديويتيد  -->  Graduated
الميترولجي  -->  metrology
اندودونتست  -->  Endodontist
برنسيه  -->  Princess
بررافو  -->  Bravo
أنيمال  -->  animal
تيمبوراري  -->  Temporary
كابيتال  -->  Capital
مانجمينت  -->  management
برتوكول  -->  protocol
كاتابوليزم  -->  Catabolism
هوسبتل  -->  Hospital
اسبيشيال  -->  special
هابيتات  -->  Habitat
أناتومي  -->  Anatomy
دومينانت  -->  Dominant
هيدروليك  -->  hydraulic
ميكرواورجانسم  -->  microorganism
الريبلاي  -->  The reply
مارڤيل  -->  Marvel
انتركونتيننتال  -->  Intercontinental
كونسيرت  -->  Concert
ماكسيموم  -->  Maximum
سيكتور  -->  Sector
أيدولوجية  -->  ideology
اوتوماتكيلي  -->  Automatically
بالاستيك  -->  plastic
وافل  -->  Waffle
نوستالجيك  -->  Nostalgic
جينيور  -->  Junior
جينيورز  -->  Juniors
بوليستر  -->  polyester
كريستاال  -->  Crystal
زيروو  -->  Zero
بيرثداي  -->  birthday
ديليت  -->  Delete
بيوكيمستري  -->  Biochemistry
فستيڤال  -->  Festival
بورسلين  -->  porcelain
فيلوستى  -->  Velocity
برينسيسه  -->  Princess
أنونيموس  -->  Anonymous
اكسبلورير  -->  explorer
ستيوبيد  -->  stupid
بروجيكتور  -->  projector
ميديسنال  -->  Medical
كولونيل  -->  colonel
نوليدج  -->  knowledge
فورميدابل  -->  formidable
سينيرچي  -->  Synergy
ميسترو  -->  Maestro
سيمينار  -->  seminar
هيدوجينية  -->  hydrogenic
فينومينولوجيا  -->  Phenomenology
اللوجوس  -->  logos
تاكسونومى  -->  Taxonomy
اندروييد  -->  Android
دبلوماسيه  -->  diplomatic
البيبولار  -->  bipolar
ماينتينانس  -->  maintenance
بروثيسيس  -->  Prothesis
بييرفيوم  -->  Perfume
سكوات  -->  squat
نيجاتيف  -->  negative
سيروم  -->  serum
سوبرهيرو  -->  Superhero
مترولوجيا  -->  metrology
بيبروني  -->  pepperoni
إسبيشيال  -->  special
مركتنج  -->  marketing
بيوتيك  -->  Biotic
تيلجرام  -->  Telegram
ترانسبورتيشن  -->  Transportation
بلووك  -->  block
ادفيزور  -->  advisor
يونيفرس  -->  Universe
ستابيليتي  -->  Stability
همبرجر  -->  Hamburger
ميسينج  -->  missing
توريست  -->  Tourist
جلسيرول  -->  glycerol
يورانيوم  -->  uranium
فرند  -->  Friend
ڤافوريت  -->  Favorite
دايابيتس  -->  Diabetes
الإتيتيود  -->  Altitude
اسبوت  -->  Spot
بيرفوريشن  -->  Perforation
بنوستالچيا  -->  Nostalgia
ينيفرسال  -->  universal
اسبرينه  -->  aspirin
ترايينج  -->  Trying
لوكوموتيف  -->  Locomotive
دفينس  -->  Defense
الهاكينج  -->  Hacking
مانيوال  -->  Manual
تيروريست  -->  Terrorist
ريموتلي  -->  remotely
بروسسر  -->  Processor
ميلكى  -->  Milky
انسومنيا  -->  insomnia
بووينت  -->  point
سفاري  -->  Safari
تلجراام  -->  Telegram
تيتنيوم  -->  titanium
ديجيتالي  -->  digitally
تيرماتك  -->  Termatic
فيرس  -->  virus
هامسترينج  -->  hamstring
الاسبيرين  -->  aspirin
بروغباندا  -->  propaganda
مللميتر  -->  millimeter
نيوترال  -->  Neutral
البلاي  -->  play
موممنت  -->  Moment
يونيفيرستى  -->  University
بوليتيكالي  -->  politically
سورس  -->  Source
كلسيوم  -->  calcium
ستيريوتايبينج  -->  Stereotyping
انثربولوجي  -->  anthropology
بانورما  -->  panorama
بوكسنج  -->  Boxing
ريدي  -->  ready
سيكس باكس  -->  six-pack
استاند  -->  stand
رومانتكيه  -->  romantic
هسيتوري  -->  history
ديسابوينتمنت  -->  Disappointment
ريليف  -->  Relief
ريسيبي  -->  Recipe
كيميستري  -->  Chemistry
أكسترا  -->  extra
سايتوبلازم  -->  cytoplasm
ستريمينج  -->  Streaming
سيرتفايد  -->  certified
استديوم  -->  stadium
تروبيكل  -->  Tropical
استاندر  -->  standard
كافيتريا  -->  cafeteria
إنسولين  -->  Insulin
بوكينج  -->  booking
بروجستيرون  -->  progesterone
تراست  -->  trust
إنيميا  -->  anemia
ستيكي  -->  sticky
ديفينس  -->  Defense
باراديس  -->  Paradise
روزماري  -->  rosemary
ستارتر  -->  starter
ميموريال  -->  Memorial
فورم  -->  form
بانوارما  -->  panorama
ايكسترييم  -->  Extreme
رويال  -->  Royal
بروتستانت  -->  Protestant
كيرياتيفتي  -->  creativity
تيبيكال  -->  Typical
دينامييت  -->  dynamite
منولوج  -->  monologue
سيتوبلازم  -->  cytoplasm
ديڤيلوبمنت  -->  Development
فيمينست  -->  Feminist
سويينج  -->  swinging
اوفردوس  -->  overdose
هيدرولوجية  -->  hydrologic
تراجيدااي  -->  Tragedy
أنجينيرنج  -->  Engineering
ديبندنس  -->  Dependence
اندرستاند  -->  Understand
آمونيوم  -->  ammonium
ابسولتلي  -->  Absolutely
جالاكسى  -->  Galaxy
بوكس  -->  box
إنيرجي  -->  Energy
ديفنتلي  -->  Definitely
إستاند  -->  stand
بروداكتيفيتي  -->  Productivity
فليكسيبليتي  -->  Flexibility
مريونيت  -->  marionette
التيستوستيرون  -->  Testosterone
كيلوة  -->  Kilo
كومبليمنت  -->  Complement
انثروبولوجية  -->  anthropology
الميترالي  -->  mitral
أوكسيجين  -->  Oxygen
أستديو  -->  studio
أندروجين  -->  Androgen
والكوير  -->  Walker
بورتو  -->  Porto
الأسيتون  -->  acetone
ليسوزيم  -->  Lysozyme
البلانكت  -->  Blanket
جينييراال  -->  General
ميلودي  -->  Melody
بادجيت  -->  budget
سفااري  -->  safari
الالباستر  -->  alabaster
مونولوجيست  -->  monologist
اسبيستون  -->  spacetoon
تايكر  -->  Taker
الإدرينالين  -->  adrenaline
مورنيننج  -->  Morning
بوسطون  -->  Boston
إكسبلورر  -->  explorer
اوف  -->  of
نوفاا  -->  nova
وايتينج  -->  Waiting
فيليمة  -->  film
سبونجي  -->  Spongy
فيرست  -->  first
ربلي  -->  Reply
بروبابلي  -->  Probably
إكسبيل  -->  expel
توايس  -->  Twice
لومباجوا  -->  Lumbago
سوفييت  -->  soviet
سناريو  -->  scenario
هابينس  -->  happiness
البلاتفورمي  -->  platform
ريبورتاجا  -->  Reportage
اونور  -->  Honor
لاكتام  -->  lactam
توماتوز  -->  tomatos
وراب  -->  and rap
أوريجيناليتي  -->  ORIGINALITY
أوديتوريوم  -->  Auditorium
اتيتيود  -->  Attitude
انتارتيكا  -->  Antarctica
اينجووي  -->  enjoy
كارنفال  -->  carnival
أيديولوجي  -->  ideological
دايجيستيف  -->  Digestive
ديسجاستينج  -->  Disgusting
هيماجلوتينين  -->  hemagglutinin
سيليبريشن  -->  Celebration
تيليجراف  -->  Telegraph
جيررل  -->  girl
هيستريا  -->  hysteria
كافيتيريا  -->  cafeteria
سبيريت  -->  Spirit
ماسيترو  -->  Maestro
الفورمالدهايد  -->  formaldehyde
الماتيريال  -->  Material
بنسيلين  -->  penicillin
نيتروجيين  -->  nitrogen
اوريجينال  -->  original
الاونجوينج  -->  Ongoing
نيجاتيفي  -->  Negative
باروسميا  -->  Parosmia
اندبيندينت  -->  Independent
بريلينت  -->  Brilliant
الفيولين  -->  violin
ماستر  -->  Master
لاب  -->  lap
سترايك  -->  strike
استاارت  -->  start
فيزيت  -->  visit
بتريتمنت  -->  treatment
اونلي  -->  only
اميبا  -->  amoeba
أستراتيجيه  -->  strategy
ديبارتمنت  -->  Department
جيولوجيى  -->  geologist
بارنويا  -->  paranoia
ريقاردليس  -->  Regardless
جرافولوجي  -->  graphology
بيتروليم  -->  Petroleum
بريزيدينت  -->  President
دروباك  -->  drawback
سبلت  -->  split
إيفينينج  -->  Evening
ترافيلنج  -->  Traveling
سينسيتيف  -->  Sensitive
ماجيستك  -->  Majestic
بلدوزر  -->  bulldozer
سرروندينج  -->  Surrounding
سادنيس  -->  Sadness
إينجوي  -->  enjoy
كرياتيف  -->  Creative
أكسبريس  -->  Express
بروتوكولى  -->  protocol
ميكستشر  -->  Mixture
اوفسبرينج  -->  Offspring
رومانتيكى  -->  romantic
سنيوور  -->  Senior
باورفول  -->  Powerful
انجريدينت  -->  Ingredient
فيتاميني  -->  vitamin
اوردنري  -->  Ordinary
أكسبلورر  -->  explorer
سكيوريتي  -->  security
بيرسوناليتي  -->  Personality
دبلوماسيةة  -->  diplomacy
سينماا  -->  cinema
اليمون  -->  lemon
سمارات  -->  Smart
كارافان  -->  caravan
أوبرا  -->  opera
رايدينج  -->  Riding
هراسمنت  -->  harassment
بوستيريور  -->  posterior
فيلترنج  -->  filtering
ريميكس  -->  remix
ديزاستير  -->  Disaster
ترادينج  -->  Trading
ريجاردينج  -->  Regarding
اوتوجراف  -->  autograph
ترليوون  -->  trillion
تيتانيوم  -->  Titanium
بروتيكتور  -->  Protector
برجماتي  -->  pragmatic
ادرينالينى  -->  Adrenaline
بيرفيوم  -->  Perfume
نابليون  -->  Napoleon
بروكسي  -->  proxy
سوبرناتشورال  -->  Supernatural
كايبورد  -->  keyboard
مورتاليتي  -->  Mortality
ابسليوتيلي  -->  Absolutely
بريسينج  -->  piercing
هولدينق  -->  holding
اسبيكترا  -->  Spectra
بريسيبتور  -->  Preceptor
بلايباك  -->  playback
سوبرفايزور  -->  Supervisor
ابسلوتللي  -->  Absolutely
دولارر  -->  dollar
ديسلايك  -->  dislike
نوستالچيا  -->  Nostalgia
ترموستات  -->  thermostat
دارلينق  -->  Darling
مكينج  -->  making
فاينالى  -->  finally
ارتيفيشياال  -->  artificial
درايفينج  -->  driving
فليكسابيليتي  -->  Flexibility
رسترت  -->  Restart
براوفوو  -->  bravo
همبورجر  -->  hamburger
بيلوجيا  -->  biological
ايررور  -->  Error
هيدروكسي  -->  hydroxy
سمينار  -->  seminar
رزيدينت  -->  Resident
داونستريم  -->  Downstream
توكسيستي  -->  toxicity
ستراوبري  -->  Strawberry
ريبلايي  -->  Reply
سليبينج  -->  sleeping
هيروجرام  -->  hierogram
سبليتر  -->  splitter
اوتوكلاف  -->  autoclave
توتوريال  -->  tutorial
سلفونيك  -->  sulfonic
اوتيستيك  -->  Autistic
سويتيي  -->  Sweetie
بوكسسينج  -->  Boxing
كونستورتيوم  -->  Consortium
دليفيري  -->  Delivery
برسيتيج  -->  Prestige
إمبروبابل  -->  improbable
انليمتيد  -->  Unlimited
رومانسية  -->  romance
تريبلكس  -->  triplex
كنجاروو  -->  Kangaroo
إيمبوسيبل  -->  Impossible
ديليفرااي  -->  Delivery
ليمونادة  -->  lemonade
جيوستراتيجي  -->  geostrategy
زجزاج  -->  zigzag
هوتنيس  -->  Hotness
مغنيسيوم  -->  Magnesium
جنيرال  -->  General
موريننج  -->  Morning
تاسكر  -->  Tasker
دنتاال  -->  dental
ستوب  -->  stop
نيوفرسال  -->  universal
سينيماتوجرافي  -->  Cinematography
نوستولوجيا  -->  Nostology
ترانسليتور  -->  Translator
نيتروجليسرين  -->  nitroglycerin
اكستيندد  -->  Extended
ترافيل  -->  Travel
ديناميت  -->  dynamite
موبايل  -->  Mobile
فيفوريت  -->  Favorite
بيراميدز  -->  pyramid
بيراميد  -->  pyramid
ديليفيري  -->  Delivery
بانتومايم  -->  pantomime
سوبرمان  -->  superman
ريدينج  -->  Reading
ساتسفينج  -->  Satisfying
وركس  -->  works
باسبوره  -->  His passport
اندستريال  -->  Industrial
تربلت  -->  triplet
ابسيولتلي  -->  Absolutely
هارموني  -->  Harmony
اسبريين  -->  aspirin
فوللوباك  -->  followback
لدبلوماسية  -->  for diplomacy
استراتيجي  -->  Strategy
ميكروبيولوجي  -->  microbiology
انينيموس  -->  Anonymous
سافاري  -->  safari
الهيدروليسيس  -->  HYDROLYSIS
ايروبيك  -->  Aerobic
لوچورنال  -->  Journal
كرياتيڤيتي  -->  Creativity
تستيستيرون  -->  testosterone
كيروسين  -->  kerosene
تراينجل  -->  Triangle
الريلاكس  -->  El Relax
يونيفورم  -->  Uniform
بلاتنيوم  -->  Platinum
تيستنج  -->  Testing
سوشاليست  -->  socialist
ستووكينج  -->  Stocking
الومنيوم  -->  Aluminium
هيموجلوبيني  -->  hemoglobin
أونورابل  -->  Honorable
ريبورتر  -->  reporter
البريكفاست  -->  El breakfast
ليڤينج  -->  Living
باكهاند  -->  backhand
هيلبب  -->  help
إستراتيجيه  -->  strategy
ساندويش  -->  sandwich
براديو  -->  b radio
اجنوستك  -->  Agnostic
بفيرس  -->  b virus
فيمنيزم  -->  feminism
انيميتد  -->  Animated
تويلايت  -->  Twilight
الجاليري  -->  El Gallery
استاتيكال  -->  statical
نوستولوجي  -->  Nostology
ريسك  -->  Risk
نيجاتف  -->  Negative
ابوكاليبس  -->  Apocalypse
وتربروف  -->  Waterproof
اندرجروند  -->  Underground
الاسيتون  -->  El acetone
جروند  -->  ground
البنسيللين  -->  El penicillin
مركتينج  -->  Marketing
اليونيفرسال  -->  El Universal
الأوتو  -->  El Auto
السيروم  -->  El serum
دليفرري  -->  Delivery
ستاندينج  -->  Standing
رميمبر  -->  Remember
لاكتوباسيلس  -->  Lactobacillus
بلياردو  -->  billiard
بتريليون  -->  b trillion
مارجرايتا  -->  Margarita
تويتير  -->  Twitter
سيستر  -->  Sister
الأوكسيجين  -->  Oxygen
البويلر  -->  the boiler
لييفل  -->  Level
بـرايا  -->  out of me
البروباجندا  -->  Propaganda
جورنالا  -->  Journal
الكلبتومانيا  -->  kleptomania
البانورامية  -->  panoramic
يور  -->  yor
هارتليس  -->  heartless
سوليتر  -->  solitaire
هوتايل  -->  hotel
دوكيومينتري  -->  Documentary
ريميندر  -->  Reminder
وهارتس  -->  Hearts
فورمالدهيد  -->  formaldehyde
تالنتد  -->  talented
تاتوو  -->  tattoo
الألارم  -->  Alarm
استيراتيجي  -->  strategic
ستارشيب  -->  starship
بريسليس  -->  Priceless
فليكسبل  -->  Flexible
ستيرليني  -->  sterling
اجنورانس  -->  ignorance
بورسالين  -->  Porcelain
سامسونيت  -->  Samsonite
ملليجرام  -->  milligram
فيلل  -->  Villa
الفودكا  -->  vodka
الراينبو  -->  rainbow
السوفييتي  -->  soviet
بيرسينت  -->  precent
تروللي  -->  trolley
وايرليس  -->  wireless
سافانا  -->  savanna
ساينتيست  -->  Scientist
الجيبرا  -->  Algebra
نورماليزو  -->  normalize
ديفرنت  -->  different
ويكلي  -->  Weekly
السيناريو  -->  El Scenario
درينكينج  -->  Drinking
كونفيرتر  -->  converter
بريستيچ  -->  Prestige
ريلاتابل  -->  Relatable
كينج  -->  King
ميندد  -->  Minded
اكسبريس  -->  Express
اكسبيرمنت  -->  Experiment
الجورنال  -->  El Journal
الهيموجلوبين  -->  El hemoglobin
الاناليتيكال  -->  El Analytical
سابواي  -->  subway
النيتورك  -->  El Network
الجيولوجيه  -->  El geology
شوجار  -->  Sugar
سينجلل  -->  single
دانس  -->  dance
ماتشينج  -->  Matching
تورنييدو  -->  Tornado
هوليداي  -->  Holiday
ستريوتايب  -->  Stereotype
باسبوور  -->  Passport
سيريال  -->  serial
كونسيكوينتلي  -->  Consequently
الدجيتال  -->  El digital
الميديسنال  -->  El Medicinal
سوشيالي  -->  socially
ردايو  -->  radio
تررند  -->  trend
باسوورد  -->  password
تريدنت  -->  Trident
نيوتن  -->  Newton
وويكيند  -->  weekend
سوفينير  -->  Souvenir
تيليقرام  -->  Telegram
اتونوميك  -->  Autonomic
تاكسونومي  -->  Taxonomy
الادرنالين  -->  El adrenaline
سامورااى  -->  samurai
ماركتير  -->  marketer
بروفسيور  -->  Professor
المينتالتي  -->  El mentality
سكليتال  -->  Skeletal
هاووس  -->  house
بريفليدج  -->  Privilege
فايند  -->  Find
هيدروكربون  -->  hydrocarbon
الانيلين  -->  El aniline
وينر  -->  Winner
بليف  -->  Believe
أونلي  -->  only
جورنـال  -->  Journal
ليرن  -->  learn
بورليتاريا  -->  proletariat
مومينت  -->  Moment
دايي  -->  day
وييكإند  -->  weekend
ايكونوميست  -->  Economist
واتشينج  -->  Watching
بريستيچي  -->  Prestige
الجلوتينين  -->  El glutenin
مينيماليزم  -->  Minimalism
اسموكنج  -->  smoking
الاستوديو  -->  El studio
استوكنج  -->  El stocking
اينفينت  -->  Infinite
إينسبايرنج  -->  Inspiring
روبووت  -->  robot
سيناريو  -->  Scenario
جيتارست  -->  guitarist
توماتوا  -->  tomato
ااسيمينار  -->  Seminar
جاكييت  -->  jacket
كوريسبوندانت  -->  Correspondent
جيفت  -->  gift
بروجرم  -->  program
أكستريم  -->  Extreme
مونستر  -->  Monster
بلاتينيوم  -->  Platinum
فيجوال  -->  visual
مودلل  -->  model
فاينالل  -->  Final
هيماتولوجى  -->  hematology
بلاتنيم  -->  platinum
ستور  -->  store
لايبراري  -->  library
الليمون  -->  El lemon
انجويمنت  -->  enjoyment
الترايدينت  -->  El Trident
انتيريستينج  -->  Interesting
هيلبينج  -->  helping
ماجيستير  -->  Master
ميسنجر  -->  Messenger
ووترمارك  -->  Watermark
جامينج  -->  gaming
لايفليس  -->  Lifeless
اندبيندنت  -->  Independent
التيليجرام  -->  El Telegram
السترويد  -->  El steroid
فرييدوم  -->  Freedom
الهيماتولوجى  -->  El hematology
إفينت  -->  Event
بريزيدنت  -->  President
ديڤينج  -->  Diving
اوتوماتيتش  -->  automatic
لمدام  -->  L madam
ستيجما  -->  stigma
إينفست  -->  Invest
هاندباج  -->  handbag
ليسته  -->  list
بكتيريولوجيا  -->  bacteriology
انفورم  -->  Inform
كوارتز  -->  quartz
ڤيروس  -->  virus
موديله  -->  model
الهيستامين  -->  El histamine
التوييت  -->  El Tweet
ميديوم  -->  medium
سويتلي  -->  Sweetly
إيديولوجي  -->  ideological
نيترات  -->  nitrate
الرتينول  -->  El retinol
يونيفرسيتى  -->  University
بدراما  -->  b Drama
اباوت  -->  about
ايربلاين  -->  Airplane
ميستري  -->  Mystery
النوستاليجيا  -->  El Nostalgia
ماركتينج  -->  Marketing
بيرفيكت  -->  perfect
هوسبيتاليتى  -->  Hospitality
دووبل  -->  double
موبيلو  -->  his Mobile
أسيمنت  -->  Assigment
باربكيو  -->  barbecue
الهاندبوك  -->  El handbook
ساونه  -->  sauna
الناتيفيتي  -->  EL Nativity
اوكتاجون  -->  Octagon
البايوتين  -->  El biotin
ساتيسفايد  -->  Satisfied
بااد  -->  Bad
داتاا  -->  data
هييلب  -->  HELP
نورماليزيشن  -->  normalization
وارمينج  -->  Warming
كاتيجوري  -->  Category
بريدجج  -->  Bridge
كيموكونو  -->  KimoCono
اناكونداا  -->  anaconda
للكاراتية  -->  L Karate
لوكيما  -->  leukemia
ميديم  -->  medium
ميدسنال  -->  medicinal
البيرسينج  -->  El piercing
سكاي  -->  Sky
بسيستم  -->  b system
السوفت  -->  El Soft
مونولوجا  -->  monologue
ربيبورت  -->  Report
ميلودراما  -->  melodrama
رووسيا  -->  Russia
اكواريوم  -->  Aquarium
الستراتيجيه  -->  El strategy
فافورتت  -->  Favorite
ديركتور  -->  director
هابي  -->  happy
النيوترينو  -->  El neutrino
البروتامين  -->  El Protamine
بسوبرمان  -->  b Superman
جليكوجين  -->  glycogen
باكتيريال  -->  bacterial
مانجيريال  -->  managerial
يونيفرسل  -->  universal
انليميتد  -->  Unlimited
سينيوورر  -->  Senior
مايندد  -->  Minded
مونتيتور  -->  Monitor
ماليجنانت  -->  Malignant
ورلد  -->  world
الهامسترنج  -->  El hamstring
الميتا  -->  El meta
جنيور  -->  Junior
ابسلوتليي  -->  Absolutely
ليوكيميا  -->  leukemia
درانك  -->  Drunk
وفليرتنج  -->  W flirting
برودكاست  -->  Broadcast
تليجراام  -->  Telegram
بروستيتيوشن  -->  Prostitution
ريزورت  -->  Resort
مونومنتال  -->  Monumental
النوستجاليا  -->  El Nostalgia
مترولوجي  -->  metrology
الجيولوجيا  -->  El geology
فيمينيست  -->  Feminist
بيدياترك  -->  Pediatric
لارج  -->  large
إكسبريس  -->  Express
اسسيسمنت  -->  Assessment
بالتسونامي  -->  b El tsunami
أيفنت  -->  Event
ميوتوال  -->  Mutual
بلوبيرد  -->  bluebird
الإيديولوجية  -->  El ideology
زومبي  -->  zombie
ابنورمال  -->  Abnormal
ستوبيد  -->  Stupid
بديناميت  -->  b dynamite
البرفورمانس  -->  El performance
انجينيرينج  -->  Engineering
استراتييجية  -->  strategy
استاديوم  -->  stadium
موديلينج  -->  Modeling
تيست  -->  test
اسبسيفيسكالي  -->  Specifically
مايبي  -->  maybe
ديلڤيري  -->  Delivery
اتاك  -->  attack
الستاتيستيكس  -->  El Statistics
نيكلوديان  -->  Nickelodeon
الجيوستراتيجية  -->  El geostrategy
فولكولورية  -->  Folkloric
فيدرالي  -->  Federal
لجيولوجية  -->  geology
الفيستفال  -->  El Festival
توتالى  -->  Totally
واتيڤير  -->  Whatever
ايفريداي  -->  Everyday
سبورتنج  -->  Sporting
هابيننج  -->  happening
ميمورى  -->  memory
انتيليجينس  -->  intelligence
نيتروجينى  -->  Nitrogenous
چينيرال  -->  General
البلاتفورم  -->  El platform
ساينج  -->  saying
تريال  -->  Trial
فريي  -->  Free
اوردر  -->  order
فييديو  -->  video
جيمناستيك  -->  Gymnastic
هيومن  -->  human
طارجيت  -->  target
وديليفري  -->  W Delivery
مجاستر  -->  master
كومبلين  -->  Complain
سووري  -->  sorry
برايسليس  -->  Priceless
الميكروبولوجي  -->  microbiology
بلاتينوم  -->  Platinum
الفلوو  -->  follow
يابارتنر  -->  Partner
بلايبوي  -->  playboy
ديستيناشن  -->  Destination
ديدبيت  -->  Deadbeat
جولوجياا  -->  geology
الكيري  -->  kiri
روتينية  -->  routine
برسسور  -->  processor
تيروم  -->  tearoom
سلينيوم  -->  selenium
المايكروبيولوجي  -->  microbiology
الفيكس  -->  Fix
فاينانسى  -->  Finance
وتروللي  -->  trolley
الهاندريل  -->  Handrail
السوسيولوجى  -->  Sociology
اكسبينسيف  -->  Expensive
اناانااس  -->  Ananas
كوابييس  -->  nightmares
بلايتنيوم  -->  Platinum
واتميتر  -->  wattmeter
اورال  -->  Oral
انونيموس  -->  Anonymous
بروفيسوره  -->  Professor
برينت  -->  print
فورمت  -->  format
رمكس  -->  remix
اوبيريتور  -->  operator
ديموجرافية  -->  demographic
ديموجرافي  -->  demographic
ساوناا  -->  sauna
لستاندارد  -->  Standard
سنووايت  -->  Snowwhite
برافووة  -->  Bravo
سليندر  -->  cylinder
ابسولوتلي  -->  Absolutely
اللويال  -->  loyal
ميننيج  -->  Mining
السبينينج  -->  Spinning
ماجنيتو  -->  Magneto
ردياتير  -->  radiator
تيريند  -->  trend
كونسالتينج  -->  Consulting
مالاريا  -->  malaria
هيدروكربونى  -->  hydrocarbon
بولونيوم  -->  polonium
ببيولوجيا  -->  b biology
اكسبورت  -->  export
السوبرهيرو  -->  El superhero
كيبوورد  -->  keyboard
ديجيتالى  -->  digitally
كريديت  -->  credit
جينرال  -->  General
مارينا  -->  Marina
ويدينج  -->  wedding
الدينامو  -->  El dynamo
والبورتفوليو  -->  W El Portfolio
الفلامنجو  -->  El flamingo
ليتراللي  -->  Literally
فينومينون  -->  phenomenon
بريستيجى  -->  My Prestige
اناليتكس  -->  Analytics
الفورملا  -->  El Formula
فالنتاين  -->  Valentine
تاستى  -->  Tasty
لاندنج  -->  Landing
ترانزستور  -->  transistor
ابستريم  -->  upstream
فايكينج  -->  Viking
الكينسيولوجي  -->  El Kinesiology
مينتاليست  -->  Mentalist
سستم  -->  system
جاللكسي  -->  Galaxy
كليبس  -->  clips
بيجيننج  -->  Beginning
دراماتيكا  -->  dramatic
اوريانتال  -->  Oriental
هيستولوجى  -->  histology
ستيجماتزم  -->  stigmatism
كوميدين  -->  comedian
بروبجاندا  -->  propaganda
إستراتجية  -->  strategic
الجوريزم  -->  Algorithm
بكيبورد  -->  b keyboard
البورتفيليو  -->  El Portfolio
الفاميلياا  -->  El Familia
بتروليوم  -->  Petroleum
جاليري  -->  Gallery
هيسترياا  -->  hysteria
چينيراتور  -->  GENERATOR
جيومورفولوجية  -->  Geomorphology
هاميستر  -->  hamster
فيو  -->  View
الجينيرال  -->  El General
نيورلوجيست  -->  Neurologist
فليكسبيلتي  -->  Flexibility
فيجيتييرين  -->  Vegetarian
هيدروستاتيكى  -->  hydrostatic
التراجيدية  -->  EL Tragedic
سايندروم  -->  Syndrome
جلوبال  -->  Global
ريلااكس  -->  Relax
الفريزير  -->  El freezer
سموكر  -->  smoker
نورماليز  -->  normalize
يونيفرسال  -->  Universal
توداى  -->  today
سوسيولوجيا  -->  Sociology
أوتفيت  -->  Outfit
مورننينج  -->  Morning
إنترناشيونال  -->  International
دوكيومنتاري  -->  Documentary
اوتوماتيكي  -->  automatic
ميلليمترا  -->  millimeter
فايروس  -->  virus
تريندد  -->  trend
سيكشوال  -->  Sexual
تولكينج  -->  Talking
الايديولوجية  -->  El ideology
ڤيجيتيريان  -->  Vegetarian
الديموكراسي  -->  El democracy
الهموجلوبين  -->  El hemoglobin
ايجنت  -->  Agent
الباند  -->  El Band
كومبليكستي  -->  Complexity
براففوو  -->  bravo
استايلست  -->  stylist
تريننج  -->  training
ريزستانت  -->  resistant
بلاستيك  -->  plastic
دفيندر  -->  Defender
الميسترال  -->  El Mistral
بروتوبلازمية  -->  Protoplasmic
ماچييستير  -->  Master
سبيسيال  -->  special
اندرویدی  -->  Android
تيليجرام  -->  Telegram
البروباجاندا  -->  El Propaganda
فريند  -->  friend
الأسيد  -->  El Acid
كربوهيدرات  -->  carbohydrate
بوتاتوس  -->  Potatoes
كاربونات  -->  carbonate
هامبورغر  -->  hamburger
داجيستيف  -->  Digestive
ستاشيون  -->  station
هيليوكوبتر  -->  helicopter
فروزين  -->  Frozen
فورايفر  -->  forever
سوفتلي  -->  softly
البرونزيه  -->  El Bronze
اسبرينات  -->  aspirins
ووركس  -->  Works
ويتينجج  -->  Waiting
بيريود  -->  period
مينتالتى  -->  mentality
هيدروجيني  -->  hydrogenic
المانجيمنت  -->  El management
باروميتر  -->  barometer
هوستينج  -->  Hosting
كرييتيفيتي  -->  Creativity
الميكروبيولوجيا  -->  El microbiology
ميدل  -->  middle
ضارلينج  -->  Darling
نوستليجا  -->  Nostalgia
استرونمي  -->  astronomical
كابيتاليزم  -->  Capitalism
الألبوم  -->  El album
فدرال  -->  Federal
ميرمايد  -->  Mermaid
غوريللا  -->  gorilla
بروفيشونال  -->  Professional
موديرن  -->  Modern
دليفيرى  -->  Delivery
تيليكرام  -->  Telegram
ليمتلس  -->  limitless
توكسكولوجي  -->  Toxology
ترانسفير  -->  transfer
باسوررد  -->  password
تريليونا  -->  trillion
جرانيت  -->  Granite
ستيرويد  -->  steroid
كواليفييد  -->  Qualified
برووجرس  -->  Progress
نوستاليجا  -->  Nostalgia
شارمينج  -->  Charming
جولوجيا  -->  geology
ترانسليت  -->  translate
ردار  -->  radar
نيمفومانيا  -->  Nymphomania
ماغنسيوم  -->  Magnesium
إكستريور  -->  Exterior
ساسبينس  -->  Suspense
فيلما  -->  film
سبورتينج  -->  Sporting
أورال  -->  Oral
رياليتي  -->  Reality
الهاندسوم  -->  El Handsome
إلاستوديو  -->  El studio
ألدبلوماسيه  -->  El diplomacy
ريسون  -->  Reason
فلكلور  -->  folklore
المانجيريال  -->  El managerial
منولوجست  -->  monologist
تستسترون  -->  testosterone
أبنورمال  -->  Abnormal
فريزر  -->  freezer
أنيمي  -->  anime
المارينا  -->  El Marina
ديهيدراشن  -->  dehydration
وسيمبل  -->  W simple
جلاجكسي  -->  Galaxy
هايدرو  -->  Hydro
جلاكسي  -->  Galaxy
ايمرالد  -->  Emerald
ليميت  -->  limit
باسبورت  -->  Passport
هالوجين  -->  halogen
اكسبيرينس  -->  Experience
بدياتريك  -->  Pediatric
سابليير  -->  supplier
السونج  -->  El Song
توموروو  -->  Tomorrow
بروستاتا  -->  prostate
نجاتيف  -->  negative
اسراتيجيا  -->  strategy
ديلوكس  -->  Deluxe
دايجستيف  -->  Digestive
بريدج  -->  Bridge
هيموفيليا  -->  hemophilia
أدوبي  -->  Adobe
ناشوناليتي  -->  Nationality
امباسادور  -->  Ambassador
ديليڤيري  -->  Delivery
جلوتامين  -->  glutamine
كيبورد  -->  keyboard
الترنتيف  -->  Alternative
ميستريس  -->  Mistress
اسسيتنت  -->  assistant
بريشيوس  -->  Precious
سيكريت  -->  secret
السيميلاتور  -->  El Simulator
بيووتيفول  -->  Beautiful
بروفيتامين  -->  provitamin
فرستلي  -->  firstly
برسونال  -->  personal
انونيموسلى  -->  Anonymously
ميكروبيولوجيا  -->  microbiology
جريننج  -->  Greening
ستديو  -->  studio
هيستريه  -->  hysteria
اكسبلور  -->  explore
جيلاتين  -->  Gelatin
دندروكرونولوجى  -->  Dendrochronology
انونيمس  -->  Anonymous
التروماتولوجي  -->  traumatology
استريم  -->  stream
بروافيلي  -->  Profile
بسكيولوجي  -->  Psychology
نيو  -->  New
يورسلف  -->  Yourself
إلسيناريو  -->  El scenario
ريدنج  -->  Reading
ليفنج  -->  Living
بوستة  -->  Post
قرووب  -->  group
الفولووينج  -->  El following
الوريكينج  -->  El working
نيكلودين  -->  Nickelodeon
ماركيتنح  -->  market
إنتركونتيننتال  -->  Intercontinental
إسترونج  -->  strong
فييلينج  -->  Feeling
استدوديو  -->  studio
يونفيرسال  -->  Universal
ميليمتر  -->  millimeter
ديستينيشن  -->  Destination
إنترتاينمنت  -->  Entertainment
نيوزروم  -->  Newsroom
كيراتين  -->  Keratin
وسيلفر  -->  W Silver
اونيست  -->  honest
أيكونوميست  -->  Economist
تيرمنولوجي  -->  Terminology
بانطس  -->  pants
كومبليتيلى  -->  Completely
سوبرماكت  -->  supermarket
ابسلوتلي  -->  Absolutely
سسيناريو  -->  scenario
مايستررو  -->  Maestro
بوسيتيف  -->  Positive
سبورتس  -->  Sports
هانديكاب  -->  handicap
الماغنيسيوم  -->  El Magnesium
ففيروس  -->  virus
ميترلوجي  -->  metrology
هيدليس  -->  headless
رياليستيك  -->  Realistic
جيلوجياا  -->  geology
برانسيس  -->  Princess
البابريكا  -->  paprika
تيستد  -->  Tested
تورندو  -->  tornado
السرمونيلا  -->  sarmonella
مايديا  -->  media
كوريدور  -->  corridor
بيستى  -->  Best
بلدينج  -->  building
تاكسى  -->  taxi
سباركر  -->  Sparker
ديودرنت  -->  Deodorant
ميديترينيان  -->  Mediterranean
بروبوزال  -->  Proposal
بوليسي  -->  police
روتر  -->  Rotter
اورجانايزر  -->  Organizer
ستآند  -->  stand
فلكلورا  -->  folklore
ايركرافت  -->  Aircraft
برايمر  -->  primer
الكاميرامان  -->  cameraman
فلولو  -->  Follow
تارتار  -->  Tartar
بووفوون  -->  Buffoon
باوور  -->  Power
أمبريال  -->  Imperial
بوستيف  -->  positive
سبووت  -->  Spot
بارتنرر  -->  Partner
انبميا  -->  anemia
ستيل  -->  Steel
بروسس  -->  Process
باصوورد  -->  password
تست  -->  test
إسباجيتي  -->  spaghetti
باسووردي  -->  password
ادفانس  -->  Advance
ميجاوت  -->  megawatt
ملليمتر  -->  millimeter
جورنال  -->  Journal
منتال  -->  mental
سوبريم  -->  Supreme
النيوترون  -->  El neutron
كاندي  -->  Candy
برينسيسا  -->  Princess
فرتشوال  -->  virtual
أسترايجية  -->  strategy
الامباسادور  -->  El Ambassador
روماتويد  -->  rheumatoid
بسكيب  -->  b Skip
ايرور  -->  ERROR
بوتينشيال  -->  Potential
انتيبيوتيك  -->  Antibiotic
أورينت  -->  Orient
ديفينيتلي  -->  Definitely
ويسكي  -->  whiskey
امازينج  -->  amazing
المورنيج  -->  El morning
سوسياتي  -->  society
ريسيت  -->  Reset
الريميندر  -->  El reminder
المولتين  -->  El molten
البايسيبس  -->  El biceps
ايمورتال  -->  immortal
ايدوول  -->  Idol
السوبرناتشورال  -->  El Supernatural
بيدچ  -->  page
يونفيرس  -->  Universe
النيتروجليسرين  -->  El nitroglycerin
ميررسي  -->  Merci
كاراتية  -->  Karate
اينجوي  -->  enjoy
السالمونيلا  -->  El salmonella
كرياتين  -->  creatine
كارتيه  -->  karate
متفيروس  -->  virus
الأنوركسيا  -->  El Anorexia
روتايشن  -->  rotation
الناتشورال  -->  El Natural
هاازارد  -->  Hazard
بيولوچي  -->  Biology
ليموون  -->  lemon
استورري  -->  story
رلاكس  -->  Relax
دراماتيكي  -->  dramatic
بانورمية  -->  panoramic
سكريمينج  -->  Screaming
كالاكسي  -->  Galaxy
انسولين  -->  Insulin
بتريند  -->  b Trend
الفلكلوري  -->  El folklore
ميتابولزم  -->  Metabolism
الاوفسبرينج  -->  El Offspring
ديسآبوينتيد  -->  Disappointed
الماندولين  -->  El mandolin
رنيوبل  -->  Renewable
السونار  -->  El sonar
الهاندلر  -->  El Handler
ترانسبيرنت  -->  transparent
البيومين  -->  albumin
ترانسناشينوال  -->  Transnational
برونزي  -->  bronze
البراجماتية  -->  El pragmatic
دوكتور  -->  Doctor
وهيستيريا  -->  W hysteria
كونسرتيوم  -->  Consortium
فورجيف  -->  Forgive
ديفيلوبر  -->  developer
امبورتانت  -->  Important
الرادار  -->  El radar
إنديبندنت  -->  Independent
إسمارت  -->  smart
ستووب  -->  stoop
بلاستييك  -->  plastic
الريدينج  -->  El Reading
ارطيست  -->  Artist
ديستركت  -->  district
بريكوميند  -->  b recommend
انترنال  -->  Internal
رسبونسيف  -->  Responsive
سورريي  -->  sorry
تالنت  -->  talent
توبس  -->  Tops
أيماجين  -->  Imagine
السافانا  -->  El savanna
توربين  -->  turbine
اسبرينكل  -->  Sprinkle
الجينتلمان  -->  El gentleman
بلوكا  -->  block
فيلمة  -->  film
البلوتنيوم  -->  El plutonium
دينامكية  -->  dynamic
البرينت  -->  El print
ستايرين  -->  styrene
رايتد  -->  rated
الريبورتاج  -->  Reportage
البوست  -->  El post
كوليستيرول  -->  cholesterol
إنفيرومينت  -->  environment
درراما  -->  drama
بيلوكاربين  -->  pilocarpine
هيدروكسيد  -->  hydroxide
باركينج  -->  parking
البانتومايم  -->  El pantomime
جوديير  -->  Goodyear
البوكسنج  -->  El boxing
ديموجرافيا  -->  demography
اليوريناري  -->  El urinary
جلاكساية  -->  Galaxy
بيوكميستري  -->  Biochemistry
ديفرينشيال  -->  Differential
التوليرانس  -->  El Tolerance
ألسونار  -->  El sonar
سبيشيالي  -->  Specially
سييكينج  -->  Seeking
انفيستمينت  -->  Investment
بينجوين  -->  Penguin
تويلت  -->  Toilet
سيكسي  -->  sexy
جلااكسي  -->  Galaxy
سموكد  -->  smoked
بتيزا  -->  pizza
عالاوريجينال  -->  El Original
فلكلوري  -->  folkloric
الهالوجين  -->  El halogen
كيرياتيفيتي  -->  creativity
بلنتي  -->  Plenty
إكسبيرينس  -->  Experience
ميكروبيولوچيا  -->  microbiology
برسونا  -->  Persona
ميكروجرام  -->  microgram
سميترية  -->  symmetry
وكردون  -->  W cordon
البورتفوليو  -->  El Portfolio
فاامووس  -->  Famous
الكونسورتيوم  -->  El Consortium
برونزية  -->  Bronze
البرودكتيفيتي  -->  El Productivity
مكسيمام  -->  Maximum
أورجنال  -->  Original
الريبورت  -->  El Report
بوكسينج  -->  Boxing
وبانورامي  -->  W panoramic
فيننشيال  -->  Financial
الانتيبيوتيك  -->  El Antibiotic
إنتيريستيد  -->  Interested
البايبولار  -->  El bipolar
بريفاينال  -->  Prefinal
اينيرجي  -->  Energy
الاسبستوس  -->  El asbestos
الهوموسيكشواليتي  -->  El homosexuality
بروتيين  -->  protein
ماريناا  -->  Marina
فورمالدهايد  -->  formaldehyde
بركينج  -->  Breaking
هيدلوجيا  -->  hydrology
بروتينا  -->  protein
هيومان  -->  human
وييرد  -->  Weird
السناب  -->  El Snap
سيميتريك  -->  symmetric
أيديلوجية  -->  ideological
فروزن  -->  Frozen
ستوري  -->  story
البروبيلين  -->  El propylene
استيودنت  -->  student
سيلفيوم  -->  silphium
السودوبوديا  -->  El pseudopodia
فانتازي  -->  fantasy
برااففو  -->  Bravo
باستل  -->  pastel
هيستيدين  -->  histidine
الكتاتونيا  -->  El Catatonia
بروتوتيب  -->  Prototype
كويلينج  -->  coiling
الاسبرين  -->  El aspirin
ليدر  -->  Leader
كاباسيتيف  -->  Capacitive
هامبرجر  -->  hamburger
اورجيناليتي  -->  originality
الهيالورونيك  -->  El Hyaluronic
فيجيتاريان  -->  Vegetarian
دي ليڨيري  -->  Delivery
النيجاتيف  -->  El negative
سينستيف  -->  Sensitive
رياكتيف  -->  Reactive
باثوبايولوجي  -->  pathobiology
تيليفيزيون  -->  Television
دينتيست  -->  dentist
اسبريد  -->  spread
الجينيراال  -->  General
سوييتي  -->  Sweety
بكيني  -->  bikini
دراما  -->  drama
توليرانس  -->  Tolerance
ميزيرابل  -->  miserable
السامسونيت  -->  El samsonite
زجزااج  -->  zigzag
هيستوباثولوجي  -->  Histopathology
السكسولوجي  -->  El sexology
هرمون  -->  hormone
كريستال  -->  Crystal
ماستربيس  -->  Masterpiece
البروتين  -->  El Protein
إنترنال  -->  INTERNAL
رومانتيكا  -->  romantic
هيستوري  -->  history
رومانسى  -->  romantic
المينينج  -->  El Meaning
الداتا  -->  El data
نيجاتييڤ  -->  Negative
بانتوثينات  -->  Pantothenate
توداي  -->  today
اچينت  -->  Agent
اونليي  -->  only
ريسبونسيف  -->  responsive
بانوراميا  -->  panoramic
المونتاج  -->  El montage
تريماتود  -->  trematode
مانيوالي  -->  manually
الجيواستراتيجية  -->  El geostrategy
فيمنست  -->  feminist
الادميرال  -->  El Admiral
هيستيري  -->  hysterical
هيدروجنيه  -->  hydrogen
وديجتال  -->  W digital
فاينللي  -->  FINALLY
فنتاستيك  -->  Fantastic
مونودراما  -->  monodrama
المورننج  -->  El morning
دنتيست  -->  dentist
ألالومنيوم  -->  El Aluminium
سكيل  -->  Skill
ديفلوبر  -->  developer
كافتيريا  -->  cafeteria
نيترو  -->  nitro
جاكت  -->  jacket
تايمينج  -->  Timing
مانيجمينت  -->  management
ماركت  -->  Market
اينستيتوت  -->  Institute
ابنورمل  -->  Abnormal
الدبلوماسية  -->  El Diplomatical
سيتوبلاسمية  -->  Cytoplasmic
فولو  -->  follow
الايبيديمولوجي  -->  El Epidemiology
أورجانيك  -->  Organic
كييب جوينج  -->  keep  going
اورجانيزر  -->  Organizer
ليڤيلينج  -->  Leveling
ساتيسفاينج  -->  Satisfying
فرتيكال  -->  Vertical
الميتوكوندريا  -->  El Mitochondria
انديبندنت  -->  Independent
ادفانسد  -->  advanced
ترانسلاتور  -->  translator
كييبينج  -->  keeping
مايكروبيولوجي  -->  microbiology
إستور  -->  store
الفورورد  -->  El Forward
تروماتيز  -->  Traumatize
اورجنيزر  -->  Organizer
بفولتميتر  -->  b voltmeter
الديفيندر  -->  El Defender
بوليتيكال  -->  political
بيلدينج  -->  building
ريلاكساشن  -->  Relaxation
لينكيد  -->  Linked
انتيبايوتيك  -->  Antibiotic
هايبوتينسيڤ  -->  Hypotensive
فليرتي  -->  flirty
الومينوم  -->  aluminum
انتركونتينينتال  -->  Intercontinental
كونفيدانت  -->  Confidant
ستايلنج  -->  Styling
ماكسيمم  -->  Maximum
الايتمولوجي  -->  El etymology
إنفيستمنت  -->  Investment
اسبليت  -->  split
منتاليتي  -->  Mentality
ليميتد  -->  Limited
ستاندراد  -->  Standard
كاربينتر  -->  Carpenter
كوانتوم  -->  Quantum
بوتاسيم  -->  Potassium
ميزوبوتاميا  -->  Mesopotamia
بيهايند  -->  Behind
الستريوتايبينج  -->  El Stereotyping
بريجننت  -->  Pregnant
رياليتى  -->  Reality
لاندينج  -->  Landing
بارتى  -->  party
البروتوتايب  -->  El Prototype
هيموجلوبين  -->  hemoglobin
تيرمنال  -->  terminal
بروجريس  -->  progress
ميلودرامي  -->  melodramatic
ريجردلس  -->  Regardless
نورمالايز  -->  normalize
نيفير  -->  never
فورافير  -->  Forever
أورجينل  -->  original
يونييرسال  -->  Universal
كومتمينت  -->  commitment
بروسيسور  -->  processor
الدريسينج  -->  El Dressing
الأوكسيتوسين  -->  El oxytocin
دييب  -->  Deep
اوبينيون  -->  Opinion
إيكونوميست  -->  Economist
ڤيجيتاريان  -->  Vegetarian
دبريسد  -->  depressed
مالتيناشونال  -->  Multinational
هارمونى  -->  Harmony
بروفيلاكسيس  -->  prophylaxis
إندينج  -->  Ending
انديبيندنت  -->  Independent
فوريفر  -->  forever
بريلليانت  -->  Brilliant
البيرسونال  -->  El Personal
الديجتال  -->  El digital
فيدباك  -->  Feedback
جنتلمن  -->  gentleman
الهيدروفلوريك  -->  El Hydrofluoric
انيمال  -->  animal
استجماتيزم  -->  astigmatism
ديفلوبمنت  -->  Development
ايرووبيك  -->  Aerobic
فليويد  -->  Fluid
فولنتير  -->  Volunteer
التوكسيكولوجي  -->  El toxicology
أوربيتال  -->  Orbital
الدايلي  -->  El Daily
دليڤيري  -->  Delivery
اورديناري  -->  ordinary
بوندينج  -->  Bonding
كونستابل  -->  Constable
اووت اووف موود  -->  out of mood
التاكسونومي  -->  El Taxonomy
ديفيلوبمنت  -->  Development
مينيمم  -->  MINIMUM
اسبورتس  -->  sports
البيرفوم  -->  El Perfume
سابتيتل  -->  subtitle
الستارتينج  -->  El starting
الراديوثيرابي  -->  El Radiotherapy
بايونير  -->  Pioneer
اوكسجين  -->  oxygen
تودااي  -->  today
الهوموورك  -->  El Homework
روماتيويد  -->  rheumatoid
اكسيتيد  -->  Excited
آنجوي  -->  enjoy
سيتوبلاسم  -->  cytoplasm
ايندليس  -->  Endless
اناتومى  -->  anatomy
البيرفورمانس  -->  El Performance
تريتمنت  -->  treatment
اوردينري  -->  ordinary
ريبورتاچ  -->  reportage
رايتينج  -->  writing
ترننج  -->  Traning
توتوميريزم  -->  tautomerism
ديدلاين  -->  Deadline
برسونالي  -->  personally
يورسيلف  -->  Yourself
دونت فورس يورسيلف  -->  Don't force yourself
ديسوردي  -->  Disorder
تراڤيل  -->  Travel
الفيروسيليكون  -->  El ferrosilicon
البوليتيكال  -->  El political
المونوتون  -->  El monotone
دايجيست  -->  Digest
آبنورمال  -->  Abnormal
المونودراما  -->  El monodrama
اوميجا  -->  Omega
الترموستات  -->  El thermostat
ستورى  -->  Story
فريندلى  -->  Friendly
اللابرادوريت  -->  El labradorite
تيستير  -->  tester
انفيستمنت  -->  investment
ميلامين  -->  Melamine
انتيفيروس  -->  Antivirus
المانجير  -->  El manger
سموكنج  -->  smoking
ديسكوفري  -->  Discovery
فلوينت  -->  fluent
سيمبلي  -->  Simply
اوريجيناال  -->  original
أوبينيون  -->  Opinion
بروجرامر  -->  Programmer
أنيواي  -->  Anyway
ماكسميم  -->  Maximium
السينسوري  -->  El Sensory
الووركينج  -->  El working
تيستورون  -->  testosterone
بيكاربوناتو  -->  bicarbonate
سبستتيوشن  -->  Substation
كولوستومي  -->  colostomy
شامبيون  -->  Champion
سيرفس  -->  service
رييبوورت  -->  Report
بييليف  -->  belive
هونيستلي  -->  Honestly
الفوندانت  -->  El fondant
بوليتكالي  -->  politically
ريلاكسيشن  -->  Relaxation
بوينتلس  -->  pointless
البارانويا  -->  El Paranoia
جنيريتور  -->  generator
كرياتيفي  -->  Creativity
ميتابوليزم  -->  Metabolism
ليفتينج  -->  Lifting
توتاليتي  -->  Totality
أنكومفورتابل  -->  Uncomfortable
افترنون  -->  afternoon
ميليتري  -->  Military
انالتيكال  -->  Analytical
هومورك  -->  Homework
داتينج  -->  Dating
ايديت  -->  Edit
المانيفولد  -->  El manifold
انتربيرسونال  -->  Interpersonal
النيجاتيفتي  -->  El Negativity
البيروكسيد  -->  El peroxide
مانجمنت  -->  management
البوزيتيفيتي  -->  El positivity
فاينانيشيال  -->  Financial
بيرستيج  -->  Prestige
نورمال  -->  normal
أر يو نورمال  -->  are you normal
الإنثروبولوجي  -->  El anthropology
ريلاتيد  -->  Related
وبيرفيكت  -->  W Perfect
مايند  -->  Mind
ناشيونال  -->  National
راتيد  -->  rated
ريكويرمنت  -->  Requirement
الدياجرام  -->  El Diagram
البروتوبلازم  -->  El protoplasm
الايستروجين  -->  El estrogen
ايفينت  -->  Event
ميدستريم  -->  Midstream
هليوم  -->  helium
ادفانتيج  -->  advatage
إيفيدينس  -->  Evidence
جليسرايد  -->  glyceride
فافورت  -->  Favorite
فريندد  -->  Friend
الترانسفيرنس  -->  El Transferance
ديموكراسي  -->  democracy
موورنينج  -->  Morning
ترينينج  -->  training
ويتيينج  -->  Waiting
الألبيومين  -->  El albumin
الترامبولين  -->  El trampoline
الهورايزون  -->  El Horizon
كينسينجتون  -->  Kensington
كونسيرتيوم  -->  Consortium
استتووب  -->  stop
فيچوال  -->  visual
فيچوال بيزك  -->  visual basic
ميكوجرام  -->  microgram
ريلاااكس  -->  Relax
جلوويينج  -->  glowing
بورنج  -->  Boring
ليف از بورنج  -->  Life is Boring
الهيدرات  -->  El hydrate
النتوورك  -->  El Network
تيوتوريال  -->  Tutorial
ميديسن  -->  Medicine
ادفانتج  -->  Advantage
الروماتويد  -->  El rheumatoid
بورنجرافي  -->  pornography
اورينتال  -->  Oriental
الأدرنالين  -->  El adrenaline
ماترياليست  -->  Materialist
الإكسيتوسين  -->  El oxytocin
بيرتداي  -->  birthday
ماستزر  -->  masters
بلييدينج  -->  Bleeding
فاميلي  -->  family
ريزونانس  -->  Resonance
اتيتود  -->  attitude
الدينتال  -->  El Dental
الديجيتال  -->  El digital
ايمبوسيبول  -->  Impossible
بوزيترونى  -->  Positron
السلينيوم  -->  El selenium
فيمينيزم  -->  feminism
ستارت  -->  start
ساتسفيد  -->  Satisfied
البوسيتيف  -->  El Positive
استاندرد  -->  Standard
ميديتيت  -->  Meditate
ستارتينج  -->  starting
البلوتونيوم  -->  El plutonium
ادفانسيد  -->  Advanced
اتتيتود  -->  Attitude
هيرتز  -->  hertz
اكستيرنال  -->  external
إينرجي  -->  Energy
بوردر  -->  Border
اكسترا  -->  extra
سيكشواليتي  -->  Sexuality
ستنرونج  -->  Strong
باراسيتولوجي  -->  Parasitology
ابيكس  -->  Apex
ديفيلوبمينت  -->  Development
البيرفورمنس  -->  El Performance
الاورجانيزر  -->  El Organizer
ارجينال  -->  original
يونيفوررم  -->  Uniform
كونتننتال  -->  Continental
كينقدوم  -->  Kingdom
الإيستروجين  -->  El estrogen
ادرينالين  -->  adrenaline
اكسترنال  -->  external
اسمارت  -->  smart
باراديز  -->  Paradise
الكاروتينويد  -->  El carotenoid
ليتراري  -->  Literary
ميدسين  -->  Medicine
ماستربييس  -->  Masterpiece
تارجيتد  -->  Targeted
سترونغ  -->  strong
الترانسفر  -->  El Transfer
ستراتوسفير  -->  stratosphere
أوريچينال  -->  original
سونار  -->  sonar
إنتركونتنينتال  -->  Intercontinental
السبيكس  -->  El Spex
سيمبلى  -->  Simply
وفييلنج  -->  Feeling
ريسنتلي  -->  Recently
النيورولوجيست  -->  El Neurologist
بيروكسايد  -->  peroxide
ريفرنس  -->  Reference
فوتومونتاج  -->  photomontage
بسيندروم  -->  b Syndrome
ستريمر  -->  streamer
برستييج  -->  prestige
الاسيمبلي  -->  El assembly
هيدريتد  -->  hydrated
انفنيتي  -->  infinity
مولدينج  -->  Molding
كوبي بيست  -->  copy paste
إنتريست  -->  interest
لووز إنتريست  -->  Lose interest
بوردينج  -->  boarding
ألتراسونيك  -->  Ultrasonic
أيدروجين  -->  hydrogen
السيمبليكس  -->  El Simplex
ايرر  -->  air
بيرفورمنس  -->  Performance
كونسولتانت  -->  Consultant
تايمس  -->  times
صنداي تايمس  -->  sunday times
اسيسيتات  -->  acetate
لاينينج  -->  Lining
اوتومات  -->  Automate
ليتريللي  -->  Literally
اسمبلي  -->  Assembly
سينجل  -->  single
سوفتنس  -->  Softness
نورمالايزيشن  -->  normalization
سيتيزين  -->  Citizen
الفامبير  -->  El vampire
بوستنج  -->  Posting
سوليد  -->  solid
سوفتي  -->  Softy
زون  -->  Zone
السكيلتال  -->  El Skeletal
ستوور  -->  store
انونيماس  -->  Anonymous
انيجما  -->  Enigma
كاتاليست  -->  Catalyst
بروسيس  -->  process
بلانكت  -->  Blanket
سيندروم  -->  Syndrome
أنيفرساري  -->  anniversary
بليدج  -->  Pledge
فلوريد  -->  fluoride
الريسيفير  -->  El receiver
أنفينتي  -->  Infinity
بريميم  -->  Premium
تيكسست  -->  text
كونتنينتال  -->  Continental
ريفوليوشن  -->  Revolution
اكسينت  -->  Accent
اناسثيسيا  -->  anaesthesia
أوبنينج  -->  Opening
كوانتتي  -->  Quantity
سينتمينتال  -->  Sentimental
نيتوورك  -->  Network
اندستري  -->  industry
الامونيوم  -->  El ammonium
جوود  -->  good
فرووزن  -->  Frozen
الأمونيوم  -->  El ammonium
مينيمال  -->  Minimal
استرنج  -->  strong
لوكد  -->  Locked
موررنينج  -->  Morning
ميلكي  -->  Milky
ريونيون  -->  reunion
جولدفيش  -->  Goldfish
رييلاكس  -->  Relax
كرازي  -->  Crazy
جينيراتور  -->  Generator
بيرسونال  -->  personal
الستايليست  -->  El stylist
يونياتيد  -->  United
ديسبنسر  -->  Dispenser
استريمر  -->  streamer
بروبليم  -->  problem
جريتنس  -->  Greatness
ديفينت  -->  Definite
ريبورتاج  -->  reportage
انتيرسيت  -->  Interset
نيجاتيفتي  -->  Negativity
سبيشياليست  -->  Specialist
ترانسبرنسى  -->  Transparency
اسكيتينج  -->  Skating
الالمينوم  -->  El aluminum
التيستيستيرون  -->  El Testosterone
فانتاستك  -->  Fantastic
ريسفير  -->  Receiver
اكستريملي  -->  Extremely
ديستنايشن  -->  Destination
ستاندارد  -->  Standard
أوتوموتيف  -->  Automotive
لوجيسكتس  -->  Logistics
ريلااكسس  -->  Relax
مالتيفوكال  -->  Multifocal
أنجوي  -->  enjoy
سبورت  -->  Sport
الترانزيستور  -->  El transistor
الفورمالديهايد  -->  El formaldehyde
بريسيدنت  -->  President
ماغنيسيوم  -->  Magnesium
ريهابليتيشن  -->  Rehabilitation
ميكروبولوجيا  -->  microbiology
البوبولار  -->  El popular
بوليتيك  -->  politic
ريسورس  -->  Resource
لوغاريتم  -->  logarithm
ميتافور  -->  metaphor
ميليغرام  -->  milligram
ديجستيف  -->  Digestive
تيبوجرافي  -->  typography
سايزس  -->  Sizes
لانجويج  -->  Language
سيلفستر  -->  sylvester
السامبلنج  -->  El sampling
الهوسبيتال  -->  El Hospital
الجوريثم  -->  Algorithm
ريلااااكس  -->  Relax
ماليفسينت  -->  Maleficent
تارجت  -->  target
استرونمى  -->  Astronomy
ستريمنج  -->  Streaming
هيلنج  -->  Healing
أوكسيتوسين  -->  oxytocin
هيدروكاربون  -->  hydrocarbon
ميديام  -->  Medium
نجياتيف  -->  Negative
ديزيرت  -->  desert
بروفورمنس  -->  performance
كوميدان  -->  comedian
هايدرازين  -->  hydrazine
فيسيولوجي  -->  physiology
الفرونت  -->  El Front
ريلاكسس  -->  Relax
هورمون  -->  hormone
ريمايندر  -->  Reminder
جيلوجي  -->  geology
نترات  -->  nitrate
ميكسد  -->  Mixed
فورجت  -->  forget
السيمبلكس  -->  El simplex
البريميم  -->  El Premium
ستورمينج  -->  Storming
براين ستورمينج  -->  Brain Storming
الهيرتز  -->  El hertz
اكسبلورر  -->  explorer
ديفولت  -->  Default
الجلوتامين  -->  El glutamine
ترانستور  -->  transistor
فيمنيست  -->  feminist
انيوااي  -->  Anyway
توكسيك  -->  Toxic
نتورك  -->  network
السيلولويد  -->  El celluloid
سيسيولوجي  -->  sociology
اسبويلر  -->  spoiler
صبلينجوال  -->  Sublingual
سينيوور  -->  Senior
برميم  -->  Premium
ميكولوجي  -->  Mycology
البالانس  -->  El  Balance
سبرايز  -->  suprise
سلايتلي  -->  Slightly
بلاتفورم  -->  platform
الهيستولوجي  -->  El histology
موورننج  -->  Morning
اللاندينج  -->  El Landing
هيدروستاتيكي  -->  hydrostatic
زوولوچي  -->  zoology
توتالي  -->  Totally
تاستي  -->  Tasty
دينتست  -->  dentist
البوستاج  -->  El Postage
سيمبوزيوم  -->  symposium
ثيرموستات  -->  thermostat
ببارانويا  -->  b paranoia
الريسبونس  -->  El response
ماينوريتي  -->  Minority
بروبرتي  -->  property
درايف  -->  drive
بلوكاج  -->  blockage
ريبوست  -->  repost
السبورتس  -->  El Sports
ريستوراشن  -->  Restoration
راديولوچي  -->  radiology
بروجيستيرون  -->  progesterone
ديوديرانت  -->  deodorant
اينستيتيوشن  -->  Institution
الميكروبيولوجيست  -->  El microbiologist
مينتينانس  -->  maintenance
هيستورى  -->  history
بيكربونات  -->  bicarbonate
سيتيزن  -->  Citizen
ادديد  -->  Added
اكسبيرت  -->  expert
اوتوبيوجرافي  -->  Autobiography
فولتج  -->  voltage
ماندولينست  -->  mandolinist
نستولجيا  -->  nostalgia
باتولوجي  -->  pathology
سيكوريتي  -->  security
ليورانيوم  -->  uranium
الهيدرازين  -->  El hydrazine
فيينال  -->  Final
كومبليت  -->  complete
الامونيا  -->  El ammonia
بماركر  -->  b Marker
بلايند  -->  Blind
لانجويچ  -->  language
إستوب  -->  stop
بروجرس  -->  Progress
بايبولارتي  -->  Bipolarity
ريزيدينت  -->  Resident
نيتريك  -->  nitric
ليمتد  -->  Limited
لوكنج  -->  looking
ريجونال  -->  Regional
سبيسيفيك  -->  Specific
بيبولار  -->  bipolar
الرويال  -->  El Royal
بروبوسال  -->  Proposal
سيلفف  -->  Self
استريمنج  -->  Streaming
موداليتي  -->  Modality
بريزون  -->  Prison
جولدن  -->  golden
مالتيناشيونال  -->  Multinational
انجوي  -->  enjoy
ترنسفير  -->  transfer
سادنس  -->  Sadness
جيواستراتيجي  -->  geostrategic
سينسيتف  -->  sensitive
لونلينيس  -->  Loneliness
أوديو  -->  audio
مايكروبيولجي  -->  microbiology
الريكرويتمينت  -->  El requirment
انتيمونى  -->  antimony
يونيتد  -->  United
الدومينانس  -->  El Dominance
نتوورك  -->  network
هيموفوبيا  -->  hemophobia
بنيفيت  -->  Benefit
فيبروما  -->  fibroma
باراجراف  -->  Paragraph
هيماتولوچي  -->  Hematology
ستاتيك  -->  static
الهيلينج  -->  El Healing
سنووز  -->  snooze
الباسكيت  -->  El Basket
واتوموتيف  -->  W Automotive
دايفينج  -->  Diving
ايليجانت  -->  elegant
ماينديد  -->  Minded
فاسكولار  -->  vascular
اسبشياليست  -->  Specialist
اورجانيك  -->  Organic
فيمنتست  -->  feminist
أوفينديد  -->  OFFENDED
سبيكترم  -->  Spectrum
نوستالجيا  -->  Nostalgia
الماليجنانسي  -->  El Malignancy
ألبيومين  -->  albumin
التيكست  -->  El Text
الجيومورفولوجي  -->  El Geomorphology
ليدينج  -->  Leading
أكستريور  -->  Exterior
كومبيتيتور  -->  Competitor
ريفيو  -->  review
سترينجر  -->  stranger
إنسترومنتال  -->  Instrumental
استيجماتيزم  -->  astigmatism
فيجيتريان  -->  Vegetarian
ترانسلاشن  -->  Translation
ميسنج  -->  missing
نيجتيف  -->  negative
ريسوليوشن  -->  Resolution
هايالرونيك  -->  Hyaluronic
ريتيد  -->  rated
اسبيدر  -->  spider
دسبنسر  -->  Dispenser
الريموتلي  -->  El remotely
فريندلي  -->  Friendly
ايدجي  -->  edgy
آيرون  -->  Iron
هارتلس  -->  Heartless
دريسر  -->  Dresser
ستروبيري  -->  Strawberry
فولدر  -->  folder
اوكسيتوسين  -->  oxytocin
ديستراكتيد  -->  distracted
باجيت ديستراكتيد  -->  b get distracted
سبيرتشوال  -->  Spiritual
واكسنج  -->  Waxing
اوبينينج  -->  Opening
كينجدوم  -->  Kingdom
سكورينج  -->  Scoring
تايمر  -->  timer
فيناليست  -->  Finalist
ترانسليشونال  -->  translational
مايكولوجي  -->  Mycology
ديستيني  -->  Destiny
ماي ديستيني  -->  My Destiny
ايميرحينسي  -->  Emergency
ريسيست  -->  resist
النوستالجيا  -->  El nostalgia
اناتوومى  -->  Anatomy
البارتي  -->  El party
كمونولوجست  -->  monologist
ڤيولين  -->  Violin
بيرسونا  -->  Persona
لوكواليتي  -->  Locality
ستراندينج  -->  Stranding
تنورمالايز  -->  T normalize
هكساجون  -->  hexagon
إنستانت  -->  instant
وابنورمال  -->  W Abnormal
كولاجين  -->  collagen
جيفتد  -->  gifted
بسايكولوجيست  -->  Psychologist
الميغالومانيا  -->  megalomania
دارلينج  -->  Darling
شيفتينج  -->  Shifting
اراتيست  -->  Artist
برميوم  -->  Premium
كونتروول  -->  control
كيتوجينك  -->  ketogenic
فوودد  -->  Food
مونولج  -->  monologue
اوكسي  -->  oxy
جولدين  -->  golden
الالارم  -->  El Alarm
البروجرامر  -->  El programmer
بورينج  -->  Boring
الومونيوم  -->  aluminium
آنفريند  -->  Unfriend
إسموكنج  -->  smoking
سادلي  -->  sadly
بيريسكوب  -->  periscope
بادچ  -->  padge
نيورولوجى  -->  Neurology
اوكسيد  -->  oxide
برايم  -->  Prime
راديوم  -->  radium
دبلوماتيك  -->  Diplomatic
ميلينيوم  -->  Millennium
الاوكستوسين  -->  El oxytocine
رياكت  -->  React
سريوسلي  -->  Seriously
ريستريكت  -->  Restrict
برجيكتور  -->  projector
سمايل  -->  smile
هوليود سمايل  -->  holywood smile
بيانيست  -->  pianist
سبورتف  -->  Sportive
ايتينج  -->  Eating
ستوريي  -->  story
الديلاي  -->  El Delay
ارتيست  -->  Artist
وباكجراوند  -->  W Background
الفامليا  -->  El familia
ديجيتل  -->  digital
اون فاير  -->  On fire
بارادايس  -->  Paradise
سليبرتي  -->  Celebrity
ميتوكوندريا  -->  mitochondria
ديسفوريا  -->  dysphoria
ياسترداي  -->  Yesterday
سيينج  -->  Saying
جست سيينج  -->  Just Saying
الاوبينينج  -->  El Opening
ريتينج  -->  rating
ميتاليك  -->  metallic
سيرفنج  -->  surffing
الفريزينج  -->  El Freezing
رفيو  -->  review
ستروبري  -->  Strawberry
اوبتيميستك  -->  Optimistic
اتومبيل  -->  Automobile
التيرمنولوجي  -->  El Terminology
الكينجدوم  -->  El Kingdom
ابستراكت  -->  abstract
الباكجروند  -->  El background
ريوستات  -->  rheostat
بورد  -->  board
الاسكور بورد  -->  El score board
الكى بورد  -->  El key board
درافت بورد  -->  Draft board
سكيت بورد  -->  skate board
الاسكيت بورد  -->  El skate board
إديوت  -->  Idiot
جيلتي  -->  Guilty
الچاليري  -->  El Gallery
ايرجينت  -->  Urgent
انيواي  -->  anyway
ماساج  -->  massage
نيوكليوتيد  -->  nucleotide
الاسيد  -->  El acid
ايكونومي  -->  Economy
هارمونيك  -->  Harmonic
ربيورت  -->  report
ميدلاند  -->  Midland
بنتونيت  -->  bentonite
انتيرنال  -->  internal
البروتوبلاست  -->  Protoplast
الداركنيس  -->  El Darkness
مونوتون  -->  Monotone
جراندما  -->  Grandma
ميلانين  -->  melanin
سوبيريور  -->  Superior
برفيكتلي  -->  perfectly
فوريست  -->  Forest
ميكينج  -->  making
السيليبرتي  -->  El Celebrity
سابميت  -->  Submit
بريسنج  -->  Piercing
فيستفال  -->  Festival
هومو  -->  homo
ابسيلوتلي  -->  Absolutely
تريدينج  -->  Trading
سيرفر  -->  Server
هيبريد  -->  Hybrid
هابننج  -->  happening
بولستر  -->  polyester
انسومونيا  -->  Insomnia
سبانك  -->  spank
المانيفست  -->  El manifest
الهيماتولوجي  -->  El Hematology
اسيمنت  -->  Assigment
الريبلااي  -->  El reply
أيروني  -->  Irony
تستوستيرون  -->  testosterone
سليبب  -->  sleep
ستاند  -->  stand
دايلى  -->  Daily
إنفنيتي  -->  Infinity
برايد  -->  Pride
سيفنتي  -->  Seventy
سايلينت  -->  Silent
بارتندر  -->  bartender
الزولوجي  -->  El Zoology
سالتد  -->  Salted
نوستالوجيا  -->  Nostalgia
فانتاسى  -->  Fantasy
هوموسيكشوال  -->  homosexual
الفليرت  -->  El flirt
فيجيتيريان  -->  Vegetarian
التنجستين  -->  El tungsten
تالينت  -->  Talent
ترانسفورماشن  -->  transformation
السوسيولوجي  -->  El Sociology
توكسيسيتيهم  -->  Their Toxicity
ماجستيك  -->  Majestic
بسيرفر  -->  b server
ديفولبمنت  -->  development
كونفيدينس  -->  Confidence
سيمولينا  -->  Semolina
سابيدر  -->  spider
اناتومي  -->  anatomy
اونيون  -->  Onion
رسيفير  -->  receiver
ديليفر  -->  Deliver
الريدوكس  -->  El Redox
فلكسبلتي  -->  Flexiblity
دينتكس  -->  Dentex
تيستتي  -->  tasty
اوفسيت  -->  Offset
نييكست  -->  next
تريبل  -->  Triple
الاسبرينت  -->  El Sprint
التوبينج  -->  El Topping
زينك  -->  Zink
البورسيلين  -->  El porcelain
الترانسفير  -->  El Transfer
بيسايد  -->  Beside
ديهيدريشن  -->  dehydration
تايجر  -->  tiger
الهيموجلبين  -->  El hemoglobin
جيتار  -->  guitar
الاستاتوس  -->  El Status
يونيفرسا  -->  Universal
سويير  -->  swear
البابيلوما  -->  El Papilloma
بسبريد  -->  b spread
الويدينج  -->  El Wedding
فينانشيال  -->  Financial
چيرمان  -->  German
النوميرو  -->  El Numero
تيستستيرون  -->  Testosterone
الريستارت  -->  El restart
فلورينس  -->  Florence
ريسبونسبيلتى  -->  Responsibility
ريتشوال  -->  Ritual
ميديتيريان  -->  Mediterranean
دوبل  -->  double
اير  -->  Air
بروبولين  -->  propylene
الانيمياا  -->  El anemia
أيديت  -->  Edit
الريتينول  -->  El retinol
الفيمينست  -->  El Feminist
ريالتي  -->  Realty
الهيبودروم  -->  El Hippodrome
فريدم  -->  freedom
أونكولوجي  -->  Oncology
اوفنديد  -->  OFFENDED
ريستوران  -->  Restaurant
اكستروفيرت  -->  extrovert
مووود  -->  Mood
سبيشاليست  -->  Specialist
ساوند  -->  sound
مينتاليتى  -->  mentality
كومبليتلي  -->  Completely
نيفرر  -->  never
فلورست  -->  Florist
كريتيفيتي  -->  Creativity
سيرفيس  -->  service
افينينج  -->  Evening
بيرسبيكتيف  -->  Perspective
أسيستانت  -->  assistant
آرتيست  -->  Artist
بينيفيت  -->  Benefit
نوستاليجيا  -->  Nostalgia
أوردر  -->  order
سينكنج  -->  Thinking
الاوفر سينكنج  -->  El Over Thinking
بريليانس  -->  Brilliance
ريوماتيزم  -->  rheumatism
بارانويا  -->  Paranoia
اوفرهيد  -->  Overhead
دريسينج  -->  Dressing
الووركنج  -->  El working
ديسكونت  -->  discount
ميكروبيولوجى  -->  microbiology
البيولوجيست  -->  El biologist
بايبولار  -->  Bipolar
سينماتوجراف  -->  cinematograph
درايفنج  -->  driving
البلتفورم  -->  El platform
ارثروبود  -->  Arthropod
البورتفليو  -->  El Portfolio
ريلايشن  -->  Relation
هستولوچي  -->  histology
انافورا  -->  Anaphora
كارتريدج  -->  cartridge
جينسيس  -->  Genesis
الأمونيا  -->  El ammonia
كوزموبوليتان  -->  Cosmopolitan
النتروجليسرين  -->  El nitroglycerin
الادرينالين  -->  El adrenaline
نيڤير  -->  Never
الجينيريتور  -->  El Generator
سوبروومن  -->  Superwoman
برايماري  -->  primary
سبيكنج  -->  Spiking
تكنكلى  -->  Technically
براكتيس  -->  practice
باتريوتيك  -->  Patriotic
سامبلنج  -->  sampling
تيليسكوب  -->  telescope
الماكسيمم  -->  El Maximum
كومديان  -->  comedian
راينبو  -->  Rainbow
بيهيفيور  -->  Behavior
الفايبراتور  -->  El vibrator
أسبونسر  -->  Sponsor
اورجنال  -->  original
موديريتور  -->  moderator
هيلبفول  -->  helpful
الليبستيك  -->  El Lipstick
ايدنتتي  -->  Identity
مينيمايز  -->  Minimize
بريزونر  -->  Prisoner
بروفاايل  -->  Profile
استيلنج  -->  Styling
انفيرتر  -->  inverter
بيوتيفول  -->  Beautiful
ببيرسينج  -->  b Piercing
ميكروبيولوچي  -->  microbiology
كوميديان  -->  comedian
بوكينيج  -->  Booking
آفيلابيلتي  -->  Availability
ماونتين  -->  Mountain
ماونتين فيو  -->  Mountain view
ريفيرانس  -->  Reference
هونيست  -->  honest
تو بي هونيست  -->  to be honest
باستوريز  -->  Pastorize
تيستي  -->  Tasty
باراناويا  -->  Paranoia
سباينال  -->  Spinal
انتيريور  -->  Interior
ايندينج  -->  Ending
باد ايندينج  -->  bad Ending
ستيتمينت  -->  Statement
نيورولوجي  -->  Neurology
بهستيريا  -->  b hysteria
ديفنسف  -->  Defensive
ايمرجنسي  -->  emergency
البيلدينج  -->  El building
ريستاارت  -->  Restart
فاملي  -->  family
موديست  -->  MODEST
ووركنج  -->  working
ووركنج فروم هوم  -->  working from home
ووركنج سبيس  -->  working space
أولتيمت  -->  Ultimate
فانتستيك  -->  Fantastic
ريمكس  -->  remix
الديفينس  -->  El Defense
بلانر  -->  planner
اورجينل  -->  original
سيفينتين  -->  seventeen
فوريفاار  -->  Forever
كومبيريسور  -->  compressor
انيوايزز  -->  Anyways
الديفيلوبمنت  -->  El Development
ساتسفاينج  -->  Satisfying
المالريا  -->  El malaria
ديستريكت  -->  District
بارتيينر  -->  partner
ريفيرنس  -->  Reference
فروز  -->  Froze
فروز ان  -->  Frozen
الفينانشيال  -->  El Financial
هابي إيندينج  -->  Happy Ending
إيندينج  -->  Ending
ديسجاستنج  -->  Disgusting
النافيجتور  -->  El Navigator
ستايلست  -->  stylist
بريڤيليج  -->  Privilege
ناتشورالل  -->  Natural
الترومبون  -->  El trombone
ديسباتش  -->  Dispatch
ليفيل  -->  Level
هانتينج  -->  Hunting
فريدوم  -->  freedom
ريبوتر  -->  Reporter
داياموند  -->  Diamond
فريزينج  -->  Freezing
اورجينال  -->  original
ارجيومنت  -->  Argument
رمايندر  -->  reminder
إكسبورت  -->  export
الويتينج  -->  El Waiting
الميمورري  -->  El Memory
فوكاليز  -->  Vocalize
ديفالويشن  -->  Devaluation
سموكينج  -->  smoking
أوتينج  -->  outing
سوشياليستا  -->  socialist
جنتلمان  -->  gentleman
آيلاند  -->  Island
فاميليير  -->  familiar
إيمبلانت  -->  Implant
ويدنج  -->  wedding
استووب  -->  stop
بلوكر  -->  blocker
نتروتولوين  -->  nitrotoluene
ابولوجيز  -->  Apologize
انتيسوشيال  -->  Antisocial
فاممووس  -->  Famous
توبليس  -->  Topless
الميكروبايولوجي  -->  El microbiology
الفينترال  -->  El ventral
هيومانيست  -->  humanist
الريتاردد  -->  El Retarded
لوونلي  -->  lonely
ميتالورجيكال  -->  Metallurgical
جييرل  -->  girl
ارتيستت  -->  Artist
فيستيڤال  -->  Festival
ماركيتير  -->  marketer
نييدليس  -->  Needles
باراسيكولوجي  -->  Parapsychology
نورمل  -->  normal
مادنيس  -->  Madness
بلاتنينيوم  -->  Platinum
ايديتت  -->  edit
برسونالتي  -->  Personality
بميتينج  -->  b meeting
سيستيسيركويد  -->  Cysticercoid
ديبرسد  -->  depressed
فيتينج  -->  Fitting
انتريور  -->  Interior
ستايليست  -->  stylist
برفورمانس  -->  Performance
سبراايز  -->  surprise
ميمبر  -->  member
جيرلي  -->  Girly
البيريود  -->  El period
أدابتيف  -->  adaptive
انستابيليتي  -->  Instability
تمبليت  -->  Templet
ستاندنج  -->  Standing
فاراداى  -->  Faraday
سآوند  -->  sound
توويليت  -->  Twilight
جليسرين  -->  glycerin
ديچيتال  -->  digital
فولوينج  -->  following
ليجالايز  -->  Legalize
بيوتيفوول  -->  Beautiful
بريمير  -->  Premier
ديڤيل  -->  Devil
امبيرور  -->  Emperor
إنديكس  -->  Index
هيليكس  -->  Helix
أكسيوم  -->  Axiom
السوسيولوچي  -->  El Sociology
ميسكاست  -->  miscast
ابسوليوتلي  -->  Absolutely
أدرينالين  -->  adrenaline
مورننج  -->  Morning
الأسيتات  -->  El acetate
سااونا  -->  sauna
بالاس  -->  Palace
هاكينج  -->  Hacking
اكسبيريينس  -->  Experience
امبلفير  -->  amplifier
فرايد  -->  Fried
فاراداي  -->  Faraday
إستريمنج  -->  Streaming
استرونج  -->  strong
دوور  -->  door
سترونق  -->  strong
هوسبتال  -->  Hospital
كادميوم  -->  Cadmium
وركينج  -->  working
وريليتابل  -->  W relatable
دانچير  -->  Danger
تاستيي  -->  Tasty
مونوكسيد  -->  monoxide
ابسلولتيلي  -->  Absolutely
ءديناميت  -->  dynamite
امايلويدوزيس  -->  amyloidosis
بيينج  -->  being
المينرال  -->  El Mineral
الهابييست  -->  El Happiest
تنورماليز  -->  T normalize
ترافل  -->  travel
ستراينجر  -->  Stranger
هيلب  -->  help
بيرسينج  -->  piercing
المانجوستين  -->  El mangosteen
امونيوم  -->  ammonium
دانسر  -->  Dancer
ينورمالايز  -->  E Normalize
بوردنج  -->  boarding
سلايس  -->  slice
ترست  -->  trust
الألومينا  -->  El Alumina
فيفر  -->  fever
بكتيريا  -->  bacteria
بوتنشيال  -->  Potential
ينورماليز  -->  E Normalize
وركنج  -->  working
بريكينغ  -->  breaking
مونكي  -->  Monkey
اكوردينج  -->  According
رايسيست  -->  RESIST
جلوكوما  -->  glaucoma
بنيوتن  -->  b Newton
مايسيلف  -->  Myself
يوور  -->  your
ليميتس  -->  limits
مولتن  -->  Molten
لاتيكس  -->  latex
نيدليس  -->  Needles
الريسستانت  -->  resistant
سبيرماتوجونيال  -->  spermatogonial
بيجننج  -->  Beginning
لوكال  -->  local
هيماتولوجي  -->  hematology
موفينق  -->  moving
هيرتبريك  -->  Heartbreak
رايدر  -->  Rider
البايمنت  -->  El Payment
اكسيبت البايمنت  -->  accept El Payment
دريسنج  -->  Dressing
دريسنج روم  -->  Dressing room
الأنيميا  -->  El anemia
السيليولويد  -->  El Celluloid
ريماتولوجي  -->  Rhematology
بوسيتيڤ  -->  Positive
مونيتور  -->  Monitor
اميزينج  -->  amazing
انالاتيكال  -->  Analytical
سوربريز  -->  Surprise
فاينانشيال  -->  Financial
يونيكورن  -->  unicorn
المينيموم  -->  El Minimum
واتيفير  -->  Whatever
موديلنج  -->  Modeling
ناشونال  -->  National
سينماتيك  -->  Cinematic
جراديواتد  -->  Graduated
الاستيريوتايبنج  -->  El stereotyping
السبورتيج  -->  El Sporting
بيوتيفل  -->  beautiful
نيكسست  -->  next
اوبراتيف  -->  Operative
بوزتيفيتي  -->  positivity
سكرينبلاي  -->  Screenplay
الجلفانوميتر  -->  El Galvanometer
كرياتيفتي  -->  Creativity
ديتيكتيف  -->  Detective
أدفانسد  -->  Advanced
وانبلوك  -->  W Unblock
ماجنيفيسنت  -->  Magnificent
مورنينح  -->  Morning
ريممبر  -->  Remember
فور ريممبر  -->  For Remember
ريممبر مي  -->  Remember me
اي ريممبر  -->  I Remember
تو ريممبر  -->  To Remember
ستيريوتايبنج  -->  Stereotyping
آنجري  -->  Angry
يونيتي  -->  Unity
بريكينج  -->  breaking
بريكينج باد  -->  breaking bad
النورمالايز  -->  El normalize
البارانورمال  -->  El Paranormal
وجينيريتور  -->  W Generator
اسبورتينج  -->  sporting
الأناليتيكال  -->  El Analytical
البيرسون  -->  El PERSON
بايوكيميستري  -->  Biochemistry
بينفيتس  -->  Benefits
فورايفرر  -->  Forever
آولد  -->  old
آولد إز جولد  -->  old is gold
ميليجرام  -->  milligram
البوتستراب  -->  El bootstrap
الديرما  -->  El derma
مينتالتي  -->  mentality
المموريال  -->  El Memorial
ماتريكس  -->  Matrix
فتنيس  -->  fitness
ريموفد  -->  REMOVED
دياجنوزيس  -->  diagnoses
رووف  -->  Roof
فاميلى  -->  family
سوسيولجي  -->  Sociology
سترونجج  -->  strong
الستاندارد  -->  El Standard
ليفننج  -->  Living
وومن  -->  WOMAN
ريفينج  -->  Revenge
واكينج  -->  waking
ميجافولت  -->  Megavolt
الساليفري  -->  El salivary
فيبراتور  -->  vibrator
الترانسفستايت  -->  El Transvestite
استايليست  -->  stylist
انليميتيد  -->  Unlimited
اكستريور  -->  Exterior
انورمالايز  -->  A Normalize
سرفايفر  -->  Survivor
ديفيلوب  -->  Develop
ريكوردر  -->  recorder
بوزيتيف  -->  Positive
اكستراكتيد  -->  extracted
المولبيدينوم  -->  El molybdenum
بيرفيكتت  -->  perfect
أمبريلا  -->  Umbrella
لوكيميا  -->  leukemia
ساسبنديد  -->  suspended
بريكننج  -->  breaking
الفاندوم  -->  El fandom
جوينج  -->  Going
كيب جوينج  -->  Keep Going
ديبندنت  -->  Dependent
سيلف ديبندنت  -->  Self Dependent
ترايلر  -->  Trailer
بالنس  -->  Balance
ناتشورال  -->  Natural
هابيى  -->  happy
هابيى نيو يير  -->  happy new year
نمبر وان  -->  number one
نمبر تو  -->  number two
نمبر  -->  number
الستيريوتايبنج  -->  El Stereotyping
بتروليم  -->  Petroleum
إمبوستر  -->  imposter
سيرب  -->  syrup
جيطاريست  -->  Guitarist
سوررى  -->  sorry
الفورميولا  -->  El Formula
ريسبيكت  -->  Respect
الوركينج  -->  El working
اسبستوس  -->  asbestos
بانكنج  -->  Banking
سباركلينج  -->  Sparkling
الهومينيد  -->  El hominid
أمونيوم  -->  ammonium
بريميوم  -->  Premium
بريفت  -->  private
ليمييت  -->  limit
الميجابارسيك  -->  El megaparsec
مييتنج  -->  meeting
هوتبوكس  -->  Hotbox
بروديوس  -->  Produce
كيلر  -->  Killer
موديول  -->  module
انوريكسيا  -->  Anorexia
مورنيينج  -->  Morning
الدياموند  -->  El Diamond
تاكسيميتير  -->  taximeter
اللوياليتي  -->  El Loyalty
بيرمنانت  -->  permanent
بيليف  -->  Believe
تستستيرون  -->  testosterone
ليجيندري  -->  legendry
فانتاستيك  -->  Fantastic
سيكيوريتي  -->  security
داييت  -->  Diet
اكسيوم  -->  Axiom
انيوايز  -->  Anyways
تومورو  -->  Tomorrow
البولونيوم  -->  El polonium
ليتيرالى  -->  Literally
سيستين  -->  cysteine
بنكرياس  -->  pancreas
سوويتي  -->  Sweety
فوريفرر  -->  Forever
كوارانتين  -->  quarantine
ديجراديشن  -->  Degradation
توليرنس  -->  Tolerance
مايننج  -->  Mining
بيوتي  -->  beauty
توتاال  -->  Total
بليسنج  -->  Blessing
لوجيستكس  -->  Logistics
ريمارك  -->  REMARK
الستريوتايبنج  -->  El Stereotyping
الريونيون  -->  El reunion
إندستريال  -->  Industrial
السيندروم  -->  El Syndrome
إنترناسيونال  -->  International
الماركيتينج  -->  El Marketing
وفاميلي  -->  W family
أوميجا  -->  Omega
جلسرين  -->  glycerin
توكسيسيتي  -->  Toxicity
ابسوليوتلى  -->  Absolutely
انجينيير  -->  engineer
ليبستيك  -->  Lipstick
ريمندر  -->  reminder
ايفرجرين  -->  evergreen
ألبنتاجون  -->  El Pentagon
كونسيرن  -->  Concern
باتلفيلد  -->  battlefield
اوزون  -->  ozone
الهيدرجين  -->  El hydrogen
الفيتينج  -->  Fitting
أيندور  -->  Indoor
إيديتور  -->  editor
سووييت  -->  Sweet
سوو سووييت  -->  soSweet
ديدنت  -->  didn't
اكسترابيراميدال  -->  Extrapyramidal
هيلينج  -->  Healing
فيسيتور  -->  visitor
بيجينر  -->  Beginner
بايمنت  -->  Payment
الترانسلتور  -->  El Translator
أوبسرفر  -->  Observer
سبيشيال  -->  special
ناتشرال  -->  natural
ميدنايت  -->  midnight
الفروزين  -->  El Frozen
سنتميتر  -->  centimeter
الانتيسوشيال  -->  El Antisocial
البولوتنيوم  -->  El plutonium
سيينجل  -->  single
سكانينج  -->  Scanning
دايناميت  -->  dynamite
ليفينق  -->  Living
الترينير  -->  El Trainer
ليرنيينج  -->  learning
سيلف ليرنيينج  -->  self learning
الأورجانيزر  -->  El Organizer
منيوال  -->  manual
فيتنيس  -->  Fitness
نتريت  -->  nitrite
بروبيلين  -->  propylene
يورسيلفز  -->  Yourselves
كلينينج  -->  cleaning
الديستروير  -->  El Destroyer
بريكلينيكال  -->  preclinical
مايكروبايولوجي  -->  microbiology
رينبو  -->  rainbow
الهيدسيت  -->  El Headset
الموبيليتي  -->  El Mobility
بكونسورتيوم  -->  b consortium
بارافين  -->  paraffin
هومليسس  -->  homeless
سيتينج  -->  Sitting
سييكر  -->  Seeker
اتنشن سييكر  -->  Attention Seeker
سيلبرتي  -->  Celebrity
دايري  -->  Diary
انالسيز  -->  Analysis
تيكيست  -->  TEXT
إند أوف ذا تيكيست  -->  End of the TEXT
باكنج  -->  Baking
برنسيس  -->  Princess
وماتيريال  -->  W Material
ماكسيمام  -->  maximum
بولر  -->  Polar
الباي بولر  -->  El bi Polar
باي بولر  -->  bi Polar
الباكينج  -->  El Baking
هابيي  -->  happy
هابيي نيو يير  -->  happy new year
هابيي نيوو يير  -->  happy new year
آليرت  -->  Alert
سولار  -->  solar
الأنتيبيوتيك  -->  El Antibiotic
نيوترون  -->  neutron
ريليتيد  -->  Related
الهيمجلوبين  -->  El hemoglobin
الاستيجماتيزم  -->  El astigmatism
ستايلينج  -->  Styling
الديفولت  -->  El Default
تروماتايز  -->  Traumatize
ماجنيفسنت  -->  Magnificent
بايسبس  -->  biceps
رييمكس  -->  remix
كويين  -->  Queen
البيوكيميستري  -->  El biochemistry
المورنينج  -->  El Morning
أنفريند  -->  Unfriend
ابلفتينج  -->  Uplifting
الكارديولوجي  -->  El Cardiology
سكالبنج  -->  Scalping
فاڤوريت  -->  Favorite
ماركتيير  -->  marketer
مارجين  -->  Margin
بيتويين  -->  between
كيننج  -->  kenning
ريسيف  -->  Receive
انسكيوريتي  -->  Insecurity
مومنت  -->  moment
أسترونج  -->  strong
الفينانس  -->  El Finance
الأوكسيتوسيتن  -->  El oxytocine
ريلاتبل  -->  Relatable
الفيمينيست  -->  feminist
ريتريفر  -->  retriever
ريلي  -->  really
هيليوم  -->  helium
ريفليكت  -->  Reflect
استوب  -->  stop
نيوو  -->  New
جااكيت  -->  jacket
بوكت  -->  pocket
نااو  -->  now
المييتنج  -->  El meeting
سترايت  -->  straight
هولو  -->  hollow
ماكسيما  -->  Maxima
ريكويست  -->  Request
نيترون  -->  neutron
براجماتكس  -->  pragmatics
التيرمينال  -->  El terminal
ريتيرن  -->  return
انوسميا  -->  Anosmia
ماجور  -->  major
فلكيس  -->  Flex
ريكوردينج  -->  Recording
ميرميد  -->  mermaid
التوكسسيتي  -->  El toxicity
بروجريسف  -->  Progressive
وفريندلي  -->  W Friendly
سبورتي  -->  sporty
كونفيرم  -->  Confirm
ايمبوسيبل  -->  Impossible
بوليجراف  -->  Polygraph
الهيليوم  -->  El helium
إيفنينج  -->  Evening
سالارى  -->  Salary
هستريا  -->  hysteria
انثروبولجي  -->  anthropology
الجرمانيوم  -->  El Germanium
أناليتيكال  -->  analytical
بلوتينيوم  -->  plutonium
فروتس  -->  fruits
اتليتيك  -->  Athletic
لوجيستيكس  -->  Logistics
سمووثلي  -->  smoothly
بريزدينت  -->  President
بيلدنج  -->  building
كونفرميد  -->  Confirmed
بارادوكس  -->  Paradox
بروفيت  -->  profit
اكواليتي  -->  Quality
كومبوند  -->  compound
مورنينجج  -->  Morning
الباراديس  -->  El Paradise
ستريكت  -->  strict
الباراميتريك  -->  El Parametric
ريجاردليس  -->  Regardless
ديزاستر  -->  Disaster
أستووب  -->  stoop
اكورديون  -->  accordion
النيورال  -->  El Neural
اندييد  -->  Indeed
بروجيكت  -->  Project
كونفيرمد  -->  Confirmed
سوشياليز  -->  Socialize
برجستيرون  -->  progesterone
درايفر  -->  Driver
الموليبدنيوم  -->  El molybdenum
ريجاردلس  -->  Regardless
السبيرم  -->  El sperm
مورفولوجي  -->  morphology
ريفلاكس  -->  Reflex
ريفليكس  -->  Reflex
بريستتيشن  -->  Prestation
الارتيست  -->  El Artist
اليجانت  -->  elegant
فيلنج  -->  Feeling
تالنتيد  -->  Talented
هيلبليس  -->  helpless
ريجيستر  -->  Register
دينتال  -->  Dental
ريكوفري  -->  recovery
ميرور  -->  Mirror
سيمستر  -->  semester
ميكسيد  -->  Mixed
اوكسيچين  -->  Oxygen
مينتور  -->  Mentor
فاينالي  -->  finally
أنجري  -->  Angry
رياليستك  -->  Realistic
اودورانت  -->  Odorant
أوزون  -->  ozone
البلاتينيوم  -->  El Platinum
واندرفول  -->  Wonderful
ماتريال  -->  Material
سلبرتي  -->  Celebrity
هوسبيتل  -->  Hospital
أبستريم  -->  Upstream
ترانسليط  -->  Translate
سليستين  -->  Celestine
تايستي  -->  Tasty
مونوفوبيا  -->  monophobia
واناليتيكال  -->  W Analytical
انجنيير  -->  Engineer
اونكولوجي  -->  Oncology
فاستنج  -->  Fasting
الفيمنيست  -->  El feminist
ديسبوزابل  -->  Disposable
فيلينيج  -->  Feeling
هيدروجيل  -->  hydrogel
هيدرومتر  -->  hydrometer
ديفايند  -->  Defined
ابسلوتيلي  -->  Absolutely
بايولوجي  -->  Biology
ساسبيند  -->  Suspend
إنترتينمينت  -->  Entertainment
سايزينج  -->  sizing
هاي ليفل سايزينج  -->  high level sizing
ميلجرام  -->  milligram
الديوتيريوم  -->  El Deuterium
اكتينج  -->  Acting
اوفر اكتينج  -->  Over Acting
وورمينج  -->  worming
الجلوبال وورمينج  -->  El global worming
الديابيتس  -->  El Diabetes
سينسيتيڤ  -->  Sensitive
الاوكسيجين  -->  El oxygen
الريسك  -->  El Risk
رندوملى  -->  Randomly
ابسلويتلي  -->  Absolutely
انفينيت  -->  Infinite
انفينيت لوب  -->  Infinite loop
فيمنسيت  -->  Feminist
ريبلالي  -->  Reply
هولوكوست  -->  Holocaust
الترانسفورمر  -->  El transformer
فيرشوال  -->  Virtual
كيلووات  -->  kilowatt
بريسدنت  -->  President
فيستيفتال  -->  Festival
هولدينج  -->  Holding
اللوكيميا  -->  El leukemia
ليميتت  -->  Limit
رستوران  -->  restaurant
ريمووف  -->  REMOVE
الستاندرد  -->  El Standard
لاتكس  -->  latex
اوكساليك  -->  oxalic
ترافيلينج  -->  Traveling
إيديت  -->  Edit
تراديشنال  -->  traditional
هاندسم  -->  handsome
انثروبولوجيا  -->  anthropology
هارمونی  -->  Harmony
فيجترين  -->  Vegetarian
دانسنج  -->  Dancing
الهيموغلوبين  -->  El hemoglobin
الريسبيراتورى  -->  El Respiratory
أوريانتاليست  -->  Orientalist
الهاندستاند  -->  El Handstand
بيوتفول  -->  Beautiful
ثينكينج  -->  Thinking
اوفر ثينكينج  -->  Over Thinking
ماريونيت  -->  marionette
ارجومنت  -->  Argument
بايولوچي  -->  Biology
الفيتنيس  -->  El Fitness
بارانوياا  -->  Paranoia
استانليس  -->  stainless
واتيفر  -->  Whatever
ريفلكس  -->  Reflex
انسبيرينج  -->  Inspiring
يونيڤيرسيتي  -->  University
فورميلا  -->  Formula
أميلويد  -->  amyloid
اللاتيكس  -->  El latex
فورماال  -->  Formal
ميسلف  -->  Myself
اوڤ ميسلف  -->  of Myself
لوف ميسلف  -->  Love Myself
البوليمر  -->  El polymer
نوتيفاي  -->  Notify
اوفينسيف  -->  Offensive
انتيجريتي  -->  Integrity
الايرجوتامين  -->  El ergotamine
سينتاكس  -->  Syntax
ريلكس  -->  Relax
الترولينج  -->  El trolling
ليجندري  -->  Legendary
ارتستيك  -->  Artistic
تااسك  -->  task
ديفرينس  -->  Difference
ريجيكت  -->  Reject
سيجاريت  -->  Cigarette
ماجيكال  -->  Magical
الساركوسيست  -->  El Sarcocyst
ماجيستيك  -->  Majestic
بايبولر  -->  Bipolar
الرياليتي  -->  El Reality
الفورمال  -->  El Formal
البيرسوناليتي  -->  El Personality
بريود  -->  period
فاستينج  -->  Fasting
الكونتينينتال  -->  El Continental
ديفيكت  -->  Defect
بايلوت  -->  Pilot
ديجيتاال  -->  digital
باثولوجي  -->  pathology
اوردينارى  -->  ordinary
الريسبيراتوري  -->  El Respiratory
ترانسليشن  -->  Translation
انفينتي  -->  infinity
بورنوجرافي  -->  Pornography
تيكست  -->  text
ساسبيندد  -->  suspended
كومفورت  -->  Comfort
كومفورت زون  -->  Comfort zone
وبيدياتريك  -->  W Pediatric
إنتركونتينينتال  -->  Intercontinental
ريستارت  -->  restart
يونيفرستي  -->  University
برادايس  -->  Paradise
الأناتومي  -->  El Anatomy
ترافيرز  -->  Traverse
ترانسفورميشن  -->  transformation
سبيكر  -->  speaker
الجرانيولوما  -->  El granuloma
استروجين  -->  estrogen
البيجمنت  -->  El Pigment
اينرجي  -->  Energy
مجنتومتري  -->  magnetometric
بيرفكتلي  -->  Perfectly
دايناميكس  -->  Dynamics
ويكند  -->  weekend
ثانكفول  -->  Thankful
اي ام ثانكفول  -->  I am Thankful
جراوندد  -->  Grounded
البيولجي  -->  El biology
مورنينق  -->  Morning
كومبلمينت  -->  Complement
نيورون  -->  Neuron
انتيبايوتك  -->  Antibiotic
استرويد  -->  steroid
بلينتى  -->  Plenty
تراجيك  -->  tragic
الهارمونيكا  -->  El harmonica
تيليباثي  -->  Telepathy
الميكروجرام  -->  El microgram
كروميوم  -->  Chromium
لايتنينج  -->  Lightning
فاينانس  -->  Finance
الاسيتات  -->  El acetate
ستيودينت  -->  student
كونتيكست  -->  CONTEXT
هاندد  -->  handed
دانسينج  -->  Dancing
البريداتور  -->  El Predator
النايتروجين  -->  El Nitrogen
بريكفاست  -->  breakfast
وورلد  -->  world
ايجنورانس  -->  ignorance
اكسكيوز ماي ايجنورانس  -->  exuse my ignorance
فاينلي  -->  Finally
الأبارتهيد  -->  El Apartheid
الميكروبيولجي  -->  El microbiology
فيتنس  -->  Fitness
منيرال  -->  Mineral
سيند  -->  Send
تيرمينال  -->  terminal
السيتينج  -->  El Setting
ديلير  -->  Dealer
سوييت  -->  sweet
كينتيكس  -->  kinetics
ريلاكسد  -->  Relaxed
ماناجر  -->  manager
ريموتلى  -->  remotely
لاينر  -->  Liner
آي لاينر  -->  eyeliner
الاى لاينر  -->  El eyeliner
تيرند  -->  trend
بينفيت  -->  Benefit
انجينير  -->  engineer
موونلايت  -->  moonlight
هايبرد  -->  Hybrid
ميليتارى  -->  military
ترموميتر  -->  thermometer
ساتسفايد  -->  Satisfied
ريدهيد  -->  redhead
موليكلار  -->  molecular
ريسستنس  -->  resistance
ريتارديشن  -->  Retardation
البوتاسيوم  -->  El potassium
هيموستات  -->  Hemostat
فييدباك  -->  Feedback
فييلنج  -->  feeling
مديسنال  -->  medicinal
الفرونتنج  -->  El fronting
يونيفرساال  -->  Universal
الرسبايراتوري  -->  El Respiratory
الهيكسوجين  -->  El hexogen
أوربيت  -->  Orbit
تاارجت  -->  target
ميتنج  -->  meeting
انيماتور  -->  Animator
سيمبل  -->  simple
سيستماتيك  -->  Systematic
انفلوينسر  -->  Influencer
بيونير  -->  Pioneer
ليمتيد  -->  Limited
تيستوسترون  -->  testosterone
سوبيريورتي  -->  Superiority
انسايكلوبيديا  -->  encyclopedia
فاميليي  -->  family
ماجنتيك  -->  Magnetic
الباراسيتولوجي  -->  El Parasitology
استيودينت  -->  student
ديسأبوينتد  -->  Disappointed
اينفستمنت  -->  investment
انسترومنتال  -->  Instrumental
الهوستري  -->  histry
سوسيولوجي  -->  Sociology
بروتيكت  -->  protect
كارديولجيست  -->  Cardiologist
برمنجنات  -->  permanganate
اللينجويستيكس  -->  El Linguistics
بروكزيمال  -->  Proximal
يونيفيرسال  -->  Universal
سيرفايفور  -->  survivor
الفورمولا  -->  El Formula
السسبيند  -->  El suspend
سكوربيون  -->  scorpion
ديريكتور  -->  director
بروكراستينيتور  -->  Procrastinator
بروتكتور  -->  Protector
فيزيتور  -->  visitor
بريكنج  -->  breaking
ريليڤانت  -->  Relevant
سكيتينج  -->  Skating
الألكالوسيس  -->  El alkalosis
سيلنت  -->  Silent
وفيسيولوجي  -->  W Physiology
سولاريوم  -->  Solarium
باراسايكولوجي  -->  Parapsychology
انيثينج  -->  Anything
اوتليت  -->  Outlet
ريسكى  -->  Risky
ميديكال  -->  medical
جيجانتيزم  -->  Gigantism
بريكدوان  -->  Breakdown
هوسبيتال  -->  Hospital
ريسيفر  -->  receiver
ريسكي  -->  Risky
سيتنج  -->  Setting
سيليكت  -->  select
يونيون  -->  union
اسيتات  -->  acetate
كونسيبت  -->  Concept
ترانزليتور  -->  Translator
بيرفورمنص  -->  performance
الهورمون  -->  El hormone
ماجنيتيك  -->  Magnetic
ريجسترى  -->  registry
نوستولجيا  -->  Nostalgia
فروت  -->  fruit
ماركتينق  -->  Marketing
كيلير  -->  Killer
فلوليس  -->  Flawless
فافوررت  -->  Favorite
بوينتليس  -->  pointless
ديبوزيت  -->  Deposit
فيليينج  -->  Feeling
انترناشيونال  -->  International
الكيندنيس  -->  El Kindness
الموديلينج  -->  El Modeling
الماركتينج  -->  El Marketing
الديسابوينتمنت  -->  El Disappointment
ميثودولوجيا  -->  Methodology
ديڤلوبمنت  -->  development
أيدروكسيد  -->  hydroxide
الهيستولوجى  -->  El histology
ابيتيزر  -->  appetizer
الانسترومنتال  -->  El instrumental
اوارنيس  -->  Awareness
صوبرمان  -->  Superman
اوريحينال  -->  original
كينسيولوجي  -->  Kinesiology
وركييننج  -->  working
البيرسونا  -->  El Persona
جليسرول  -->  glycerol
فايتينج  -->  fighting
سااد  -->  sad
ميتال  -->  metal
جيوبوليتكال  -->  Geopolitical
فليرتينج  -->  flirting
باكجراوند  -->  Background
دياموند  -->  Diamond
الأنتروبولوجيا  -->  El Anthropology
التراينينج  -->  El training
الستوكينج  -->  El stocking
إيفينت  -->  Event
اتتيتيود  -->  Attitude
الديماند  -->  El demand
داياجرام  -->  Diagram
البيرسونالتى  -->  El Personalty
السنسوري  -->  El sensory
البرسوناليتي  -->  El Personality
ديفيندر  -->  Defender
الترمنولوجي  -->  El Terminology
جيروسكوبي  -->  gyroscopic
بلوتونيوم  -->  plutonium
جلاوكوس  -->  Glaucous
ماراثون  -->  marathon
بنوستالجيا  -->  b Nostalgia
الريكوردينج  -->  El Recording
التستوستيرون  -->  El testosterone
كريمنال  -->  Criminal
النورمال  -->  El normal
داارلينغ  -->  Darling
هستامين  -->  histamine
ميجاوايت  -->  megawatt
الاتروبين  -->  El atropine
بريكفست  -->  breakfast
هيلثي بريكفست  -->  Healty breakfast
نبيوليزر  -->  nebulizer
دياجنوزس  -->  diagnoses
بروكين  -->  Broken
فيلينج بروكين  -->  Feeling Broken
اريدي بروكين  -->  Already Broken
اوريدي بروكين  -->  Already Broken
بروكين هارت  -->  Broken Heart
هرت بروكين  -->  Heart Broken
اولريدي بروكين  -->  Already Broken
الفيرتشوال  -->  El virtual
الفراجيليتي  -->  El fragility
بكتريولوجي  -->  bacteriology
لونلي  -->  lonely
لونلي مى  -->  lonely me
اليورانيوم  -->  El uranium
هابنينج  -->  happening
هابنينج ناو  -->  happening now
الاكسيتوسين  -->  El oxytocin
بالراديوم  -->  b El radium
سينكينج  -->  Thinking
اوڤر سينكينج  -->  Over Thinking
الأوڤر سينكينج  -->  El Over Thinking
الأوفر سينكينج  -->  El Over Thinking
السيرفير  -->  El server
الاوتونوميك  -->  El Autonomic
ستيودنت  -->  Student
لوكينج  -->  looking
لوكينج جريت  -->  looking great
لوكينج فور  -->  looking for
كيوت لوكينج  -->  cute looking
لوكينج ات ذا برايت سايد  -->  looking at the bright side
اوبين  -->  open
سيكرتلي  -->  secretly
الستيريوتايب  -->  El Stereotype
فيرچين  -->  Virgin
الأوتوماتيك  -->  El automatic
فلينج  -->  feeling
باارتي  -->  party
أوتوموتور  -->  automotor
ريلاتد  -->  Related
الفاميلي  -->  El family
الليميت  -->  limit
مسدچ الليميت  -->  message El limit
ديفولوب  -->  Develop
اوريجنال  -->  original
الواكسينج  -->  El Waxing
تيكنولوجي  -->  technology
الادفيرتيزينج  -->  El advertising
زونينج  -->  zoning
نيوروفسيولوجي  -->  Neurophysiology
بيكاربونات  -->  bicarbonate
ستايل  -->  style
كونتينتال  -->  Continental
انجولار  -->  Angular
ديستنس  -->  distance
اللونج ديستنس  -->  El long distance
لونق ديستنس  -->  long distance
سوربرايزنجلي  -->  Surprisingly
فريست  -->  first
فريست لوك  -->  first look
اتتيود  -->  Attitude
ديسيرت  -->  desert
إستروجين  -->  estrogen
أوبسرفاتوري  -->  observatory
فوريفير  -->  Forever
كراياتيفيتي  -->  Creativity
سيجنل  -->  Signal
ديستروير  -->  Destroyer
البايولوجي  -->  El Biology
هاندسوم  -->  Handsome
بروفيشينال  -->  Professional
سبيكتايتور  -->  Spectator
ميكروميليمتر  -->  micromillimeter
نيجاتيفتى  -->  Negativity
كومباراتيف  -->  Comparative
ولوكيميا  -->  W leukemia
رسبيرتوري  -->  Respiratory
ديريكت  -->  direct
