الهيموجلوبين --> El hemoglobin
الاناليتيكال --> El Analytical
كونسيكوينتلي --> Consequently
كوريسبوندانت --> Correspondent
الهيماتولوجى --> El hematology
بكتيريولوجيا --> bacteriology
النوستاليجيا --> El Nostalgia
الإيديولوجية --> El ideology
اسبسيفيسكالي --> Specifically
الستاتيستيكس --> El Statistics
والبورتفوليو --> W El Portfolio
الكينسيولوجي --> El Kinesiology
هيدروستاتيكى --> hydrostatic
إنترناشيونال --> International
الايديولوجية --> El ideology
بروتوبلازمية --> Protoplasmic
البروباجاندا --> El Propaganda
عالاوريجينال --> El Original
الكونسورتيوم --> El Consortium
الانتيبيوتيك --> El Antibiotic
الهيالورونيك --> El Hyaluronic
باثوبايولوجي --> pathobiology
الأوكسيتوسين --> El oxytocin
مالتيناشونال --> Multinational
البيرفورمانس --> El Performance
اللابرادوريت --> El labradorite
أنكومفورتابل --> Uncomfortable
انتربيرسونال --> Interpersonal
البوزيتيفيتي --> El positivity
أر يو نورمال --> are you normal
البروتوبلازم --> El protoplasm
الترانسفيرنس --> El Transferance
ليف از بورنج --> Life is Boring
باراسيتولوجي --> Parasitology
الكاروتينويد --> El carotenoid
لووز إنتريست --> Lose interest
نورمالايزيشن --> normalization
الترانزيستور --> El transistor
ميكروبولوجيا --> microbiology
هيدروستاتيكي --> hydrostatic
اوتوبيوجرافي --> Autobiography
جيواستراتيجي --> geostrategic
مايكروبيولجي --> microbiology
الماليجنانسي --> El Malignancy
ترانسليشونال --> translational
بسايكولوجيست --> Psychologist
هوليود سمايل --> holywood smile
التيرمنولوجي --> El Terminology
الاسكور بورد --> El score board
الاسكيت بورد --> El skate board
البروتوبلاست --> Protoplast
الهيماتولوجي --> El Hematology
ترانسفورماشن --> transformation
ريسبونسبيلتى --> Responsibility
ميكروبيولوجى --> microbiology
كوزموبوليتان --> Cosmopolitan
ميكروبيولوچي --> microbiology
تو بي هونيست --> to be honest
الديفيلوبمنت --> El Development
هابي إيندينج --> Happy Ending
ميتالورجيكال --> Metallurgical
باراسيكولوجي --> Parapsychology
سيستيسيركويد --> Cysticercoid
امايلويدوزيس --> amyloidosis
الجلفانوميتر --> El Galvanometer
ستيريوتايبنج --> Stereotyping
البارانورمال --> El Paranormal
الأناليتيكال --> El Analytical
بايوكيميستري --> Biochemistry
آولد إز جولد --> old is gold
المولبيدينوم --> El molybdenum
سيلف ديبندنت --> Self Dependent
الميجابارسيك --> El megaparsec
إنترناسيونال --> International
الانتيسوشيال --> El Antisocial
الأنتيبيوتيك --> El Antibiotic
الكارديولوجي --> El Cardiology
الباراميتريك --> El Parametric
الموليبدنيوم --> El molybdenum
الترانسفورمر --> El transformer
انثروبولوجيا --> anthropology
الهيموغلوبين --> El hemoglobin
أوريانتاليست --> Orientalist
اوفر ثينكينج --> Over Thinking
الايرجوتامين --> El ergotamine
ترانسفورميشن --> transformation
الجرانيولوما --> El granuloma
انترناشيونال --> International
البيرسونالتى --> El Personalty
البرسوناليتي --> El Personality
التستوستيرون --> El testosterone
اريدي بروكين --> Already Broken
اوڤر سينكينج --> Over Thinking
الستيريوتايب --> El Stereotype
مسدچ الليميت --> message El limit
سوربرايزنجلي --> Surprisingly
ميكروميليمتر --> micromillimeter
هيدروكلوريد --> hydrochloride
الأبارتهايد --> Apartheid
الماينتاينر --> maintainer
الراديولوچي --> radiology
اينتومولوجي --> Entomology
أيديولوجيست --> ideologist
اندرستاندنج --> Understanding
اوتوماتيكلي --> Automatically
الفانتاستيك --> Fantastic
الماركتيينج --> Marketing
أستيجماتيزم --> astigmatism
الهايدروجين --> hydrogen
تيستوستيرون --> Testosterone
بيبليوجرافي --> bibliography
الميكروفيلم --> microfilm
المينتاليتى --> Mentality
الفولفيلمنت --> Fulfillment
الراديولوجى --> radiology
الجيرياتريك --> Geriatric
استيراتيجية --> strategy
أنثروبولوجي --> anthropology
ميجالومانيا --> Megalomania
ميثودولوجية --> Methodology
الاوبتيميسم --> optimism
كونتينينتال --> Continental
جيرونتولوجى --> gerontology
الساليسيليك --> salicylic
استيروتيبنج --> Stereotyping
التوكسيسيتي --> toxicity
كليبتومانيا --> kleptomania
الابيديرميس --> Epidermis
البرولاكتين --> prolactin
الأوتوموبيل --> Automobile
الأكسيتوسين --> oxytocin
الموديريتور --> moderator
البوليسترين --> polystyrene
اوتوماتكيلي --> Automatically
فليكسيبليتي --> Flexibility
الإدرينالين --> adrenaline
البلاتفورمي --> platform
بيرسوناليتي --> Personality
ارتيفيشياال --> artificial
كونستورتيوم --> Consortium
جيوستراتيجي --> geostrategy
هيموجلوبيني --> hemoglobin
اليونيفرسال --> El Universal
