سيمبوليك --> symbolic
الدبلوما --> Diploma
اوتماتيك --> automatic
نفيجاتور --> Navigator
استادیوم --> stadium
جادجمينت --> Judgment
البليندر --> blender
اوكسوجين --> Oxygen
جيتاريست --> Guitarist
توكسيستى --> Toxicity
أدفيسوري --> advisory
الديسبلي --> DISPLAY
استراتجي --> strategic
هامبورجر --> hamburger
فيرولوجي --> virology
سيليبرتي --> Celebrity
ماتيريال --> Material
جيولوجين --> geologians
ريستارتت --> Restart
بروبجندا --> propaganda
سكيليتون --> Skeleton
چينيرالي --> General
نستالجيا --> Nostalgia
جيولوجيا --> geology
ليمونادا --> lemonade
ليموناده --> lemonade
ألومينوم --> aluminum
السيريال --> serial
انوركسيا --> Anorexia
باسوورده --> password
اندورويد --> Android
بارانويد --> Paranoid
ڤيرتشوال --> Virtual
رييلااكس --> RELAX
بانورامى --> panoramic
هامبروجر --> Hamburger
ماركيتنج --> Marketing
نيتروجين --> Nitrogen
اوكسيجين --> Oxygen
هيباتوما --> Hepatoma
ريكوردنج --> Recording
كومبوننت --> Component
هيسترويا --> hysteria
بلاستيكة --> plastic
سيناريوا --> scenario
اتوموبيل --> Automobile
الجلوبال --> Global
أوميكرون --> Omicron
بيروكسيد --> peroxide
الراديوم --> radium
فايبرويد --> fibroid
البانانا --> Banana
واركرافت --> warcraft
استيرلنج --> sterling
تمبرلاند --> Timberland
سيناريوه --> scenario
وسولديرر --> soldier
جيولوجيه --> geology
التوربيد --> torpedo
فيجتريان --> Vegetarian
اسفيكسيا --> Asphyxia
جيلاتيين --> gelatin
النيتريت --> nitrite
فورايفير --> Forever
مانجمينت --> management
اسبيشيال --> special
دومينانت --> Dominant
هيدروليك --> hydraulic
الريبلاي --> The reply
ماكسيموم --> Maximum
بالاستيك --> plastic
كريستاال --> Crystal
برينسيسه --> Princess
أنونيموس --> Anonymous
ميديسنال --> Medical
اندروييد --> Android
بروثيسيس --> Prothesis
بييرفيوم --> Perfume
سوبرهيرو --> Superhero
إسبيشيال --> special
يورانيوم --> uranium
دايابيتس --> Diabetes
ينيفرسال --> universal
الهاكينج --> Hacking
تيروريست --> Terrorist
انسومنيا --> insomnia
ديجيتالي --> digitally
كيميستري --> Chemistry
ستريمينج --> Streaming
سيرتفايد --> certified
كافيتريا --> cafeteria
ميموريال --> Memorial
بانوارما --> panorama
دينامييت --> dynamite
ابسولتلي --> Absolutely
أوكسيجين --> Oxygen
أندروجين --> Androgen
الأسيتون --> acetone
البلانكت --> Blanket
اسبيستون --> spacetoon
مورنيننج --> Morning
إكسبلورر --> explorer
بروبابلي --> Probably
لومباجوا --> Lumbago
تيليجراف --> Telegraph
نيجاتيفي --> Negative
باروسميا --> Parosmia
الفيولين --> violin
بتريتمنت --> treatment
جيولوجيى --> geologist
بيتروليم --> Petroleum
إيفينينج --> Evening
ترافيلنج --> Traveling
سينسيتيف --> Sensitive
فيتاميني --> vitamin
أكسبلورر --> explorer
سكيوريتي --> security
ديزاستير --> Disaster
اوتوجراف --> autograph
تيتانيوم --> Titanium
اسبيكترا --> Spectra
ترموستات --> thermostat
درايفينج --> driving
هيدروكسي --> hydroxy
توكسيستي --> toxicity
ستراوبري --> Strawberry
هيروجرام --> hierogram
اوتوكلاف --> autoclave
توتوريال --> tutorial
اوتيستيك --> Autistic
بوكسسينج --> Boxing
انليمتيد --> Unlimited
رومانسية --> romance
ليمونادة --> lemonade
مغنيسيوم --> Magnesium
نيوفرسال --> universal
اكستيندد --> Extended
بيراميدز --> pyramid
ديليفيري --> Delivery
ساتسفينج --> Satisfying
فوللوباك --> followback
انينيموس --> Anonymous
لوچورنال --> Journal
