الريلاكس --> El Relax
يونيفورم --> Uniform
بلاتنيوم --> Platinum
سوشاليست --> socialist
ستووكينج --> Stocking
الومنيوم --> Aluminium
أونورابل --> Honorable
الجاليري --> El Gallery
الاسيتون --> El acetone
ستاندينج --> Standing
بتريليون --> b trillion
ستيرليني --> sterling
اجنورانس --> ignorance
بورسالين --> Porcelain
سامسونيت --> Samsonite
ملليجرام --> milligram
الراينبو --> rainbow
ساينتيست --> Scientist
درينكينج --> Drinking
كونفيرتر --> converter
ريلاتابل --> Relatable
الجورنال --> El Journal
النيتورك --> El Network
تورنييدو --> Tornado
الدجيتال --> El digital
تيليقرام --> Telegram
اتونوميك --> Autonomic
سامورااى --> samurai
بروفسيور --> Professor
بريفليدج --> Privilege
الانيلين --> El aniline
بريستيچي --> Prestige
لايبراري --> library
انجويمنت --> enjoyment
ماجيستير --> Master
ووترمارك --> Watermark
السترويد --> El steroid
بريزيدنت --> President
الرتينول --> El retinol
ايربلاين --> Airplane
ماركتينج --> Marketing
اوكتاجون --> Octagon
كاتيجوري --> Category
كيموكونو --> KimoCono
مونولوجا --> monologue
اكواريوم --> Aquarium
بسوبرمان --> b Superman
جليكوجين --> glycogen
يونيفرسل --> universal
انليميتد --> Unlimited
سينيوورر --> Senior
مونتيتور --> Monitor
ليوكيميا --> leukemia
وفليرتنج --> W flirting
برودكاست --> Broadcast
تليجراام --> Telegram
مترولوجي --> metrology
فيمينيست --> Feminist
بيدياترك --> Pediatric
اسسيسمنت --> Assessment
ابنورمال --> Abnormal
بديناميت --> b dynamite
استاديوم --> stadium
موديلينج --> Modeling
ايفريداي --> Everyday
وديليفري --> W Delivery
برايسليس --> Priceless
بلاتينوم --> Platinum
يابارتنر --> Partner
جولوجياا --> geology
فاينانسى --> Finance
اناانااس --> Ananas
انونيموس --> Anonymous
بولونيوم --> polonium
ديجيتالى --> digitally
الدينامو --> El dynamo
ليتراللي --> Literally
بريستيجى --> My Prestige
اناليتكس --> Analytics
الفورملا --> El Formula
فالنتاين --> Valentine
الجوريزم --> Algorithm
بتروليوم --> Petroleum
هيسترياا --> hysteria
سايندروم --> Syndrome
الفريزير --> El freezer
نورماليز --> normalize
مورننينج --> Morning
استايلست --> stylist
ريزستانت --> resistant
اندرویدی --> Android
تيليجرام --> Telegram
كاربونات --> carbonate
هامبورغر --> hamburger
داجيستيف --> Digestive
اسبرينات --> aspirins
مينتالتى --> mentality
باروميتر --> barometer
نوستليجا --> Nostalgia
استرونمي --> astronomical
تيليكرام --> Telegram
ترانسفير --> transfer
تريليونا --> trillion
ترانسليت --> translate
ماغنسيوم --> Magnesium
إكستريور --> Exterior
سبورتينج --> Sporting
منولوجست --> monologist
تستسترون --> testosterone
أبنورمال --> Abnormal
المارينا --> El Marina
بدياتريك --> Pediatric
بروستاتا --> prostate
دايجستيف --> Digestive
ديليڤيري --> Delivery
جلوتامين --> glutamine
الترنتيف --> Alternative
بروافيلي --> Profile
نيكلودين --> Nickelodeon
ماركيتنح --> market
استدوديو --> studio
سوبرماكت --> supermarket
ابسلوتلي --> Absolutely
سسيناريو --> scenario
مايستررو --> Maestro
هانديكاب --> handicap
ميترلوجي --> metrology
جيلوجياا --> geology
بروبوزال --> Proposal
ايركرافت --> Aircraft
إسباجيتي --> spaghetti
باسووردي --> password
برينسيسا --> Princess
روماتويد --> rheumatoid
المورنيج --> El morning
المولتين --> El molten
ايمورتال --> immortal
بانورمية --> panoramic
سكريمينج --> Screaming
الهاندلر --> El Handler
البيومين --> albumin
ديفيلوبر --> developer
بلاستييك --> plastic
