الريدينج --> El Reading
رسبونسيف --> Responsive
السافانا --> El savanna
اسبرينكل --> Sprinkle
دينامكية --> dynamic
البوكسنج --> El boxing
جلاكساية --> Galaxy
سبيشيالي --> Specially
الريبورت --> El Report
فيننشيال --> Financial
هيدلوجيا --> hydrology
سيميتريك --> symmetric
استيودنت --> student
هيستيدين --> histidine
بروتوتيب --> Prototype
الاسبرين --> El aspirin
توليرانس --> Tolerance
ميزيرابل --> miserable
ماستربيس --> Masterpiece
البروتين --> El Protein
المينينج --> El Meaning
نيجاتييڤ --> Negative
المونتاج --> El montage
تريماتود --> trematode
مانيوالي --> manually
فنتاستيك --> Fantastic
المورننج --> El morning
كافتيريا --> cafeteria
أورجانيك --> Organic
ليڤيلينج --> Leveling
الفورورد --> El Forward
تروماتيز --> Traumatize
اورجنيزر --> Organizer
الومينوم --> aluminum
منتاليتي --> Mentality
ستاندراد --> Standard
كاربينتر --> Carpenter
كومتمينت --> commitment
بروسيسور --> processor
اوبينيون --> Opinion
الديجتال --> El digital
ايرووبيك --> Aerobic
أوربيتال --> Orbital
كونستابل --> Constable
البيرفوم --> El Perfume
اوردينري --> ordinary
ريبورتاچ --> reportage
برسونالي --> personally
آبنورمال --> Abnormal
المانجير --> El manger
ديسكوفري --> Discovery
أوبينيون --> Opinion
بروجرامر --> Programmer
تيستورون --> testosterone
رييبوورت --> Report
هونيستلي --> Honestly
جنيريتور --> generator
كرياتيفي --> Creativity
توتاليتي --> Totality
وبيرفيكت --> W Perfect
ناشيونال --> National
ميدستريم --> Midstream
ادفانتيج --> advatage
إيفيدينس --> Evidence
جليسرايد --> glyceride
موورنينج --> Morning
ميكوجرام --> microgram
ريلاااكس --> Relax
جلوويينج --> glowing
الهيدرات --> El hydrate
النتوورك --> El Network
اورينتال --> Oriental
بلييدينج --> Bleeding
ريزونانس --> Resonance
الدينتال --> El Dental
فيمينيزم --> feminism
استاندرد --> Standard
ستارتينج --> starting
ادفانسيد --> Advanced
اكسترنال --> external
بسيندروم --> b Syndrome
أيدروجين --> hydrogen
اسيسيتات --> acetate
ليتريللي --> Literally
الفامبير --> El vampire
انونيماس --> Anonymous
كاتاليست --> Catalyst
موررنينج --> Morning
بيرسونال --> personal
يونياتيد --> United
ريبورتاج --> reportage
انتيرسيت --> Interset
اسكيتينج --> Skating
فانتاستك --> Fantastic
ستاندارد --> Standard
لوجيسكتس --> Logistics
ريلااكسس --> Relax
بريسيدنت --> President
لوغاريتم --> logarithm
ميليغرام --> milligram
الجوريثم --> Algorithm
استرونمى --> Astronomy
ريمايندر --> Reminder
البريميم --> El Premium
ستورمينج --> Storming
اكسبلورر --> explorer
ترانستور --> transistor
ميكولوجي --> Mycology
البالانس --> El  Balance
بلاتفورم --> platform
البوستاج --> El Postage
السبورتس --> El Sports
نستولجيا --> nostalgia
باتولوجي --> pathology
سيكوريتي --> security
الامونيا --> El ammonia
ريزيدينت --> Resident
سبيسيفيك --> Specific
بروبوسال --> Proposal
استريمنج --> Streaming
موداليتي --> Modality
لونلينيس --> Loneliness
انتيمونى --> antimony
باراجراف --> Paragraph
الهيلينج --> El Healing
الباسكيت --> El Basket
ايليجانت --> elegant
فاسكولار --> vascular
اورجانيك --> Organic
أوفينديد --> OFFENDED
ألبيومين --> albumin
أكستريور --> Exterior
ستروبيري --> Strawberry
اوبينينج --> Opening
فيناليست --> Finalist
اناتوومى --> Anatomy
كونتروول --> control
كيتوجينك --> ketogenic
بيريسكوب --> periscope
ميلينيوم --> Millennium
ريستريكت --> Restrict
برجيكتور --> projector
الفامليا --> El familia
