اون فاير --> On fire
بارادايس --> Paradise
ديسفوريا --> dysphoria
ياسترداي --> Yesterday
ابستراكت --> abstract
الچاليري --> El Gallery
ايكونومي --> Economy
هارمونيك --> Harmonic
انتيرنال --> internal
سوبيريور --> Superior
برفيكتلي --> perfectly
الزولوجي --> El Zoology
سيمولينا --> Semolina
الريدوكس --> El Redox
فلكسبلتي --> Flexiblity
التوبينج --> El Topping
يونيفرسا --> Universal
الويدينج --> El Wedding
النوميرو --> El Numero
بروبولين --> propylene
ريستوران --> Restaurant
أسيستانت --> assistant
بريليانس --> Brilliance
بارانويا --> Paranoia
الووركنج --> El working
بايبولار --> Bipolar
ارثروبود --> Arthropod
هستولوچي --> histology
كارتريدج --> cartridge
الأمونيا --> El ammonia
سوبروومن --> Superwoman
برايماري --> primary
تيليسكوب --> telescope
بيهيفيور --> Behavior
مينيمايز --> Minimize
بروفاايل --> Profile
بيوتيفول --> Beautiful
ببيرسينج --> b Piercing
كوميديان --> comedian
ريفيرانس --> Reference
باستوريز --> Pastorize
انتيريور --> Interior
ستيتمينت --> Statement
بهستيريا --> b hysteria
ايمرجنسي --> emergency
ريستاارت --> Restart
فانتستيك --> Fantastic
الديفينس --> El Defense
سيفينتين --> seventeen
فوريفاار --> Forever
انيوايزز --> Anyways
المالريا --> El malaria
ديستريكت --> District
بارتيينر --> partner
بريڤيليج --> Privilege
داياموند --> Diamond
اورجينال --> original
ارجيومنت --> Argument
الويتينج --> El Waiting
فاميليير --> familiar
إيمبلانت --> Implant
ابولوجيز --> Apologize
فيستيڤال --> Festival
ماركيتير --> marketer
ستايليست --> stylist
البيريود --> El period
ليجالايز --> Legalize
الأسيتات --> El acetate
إستريمنج --> Streaming
مونوكسيد --> monoxide
ءديناميت --> dynamite
المينرال --> El Mineral
ستراينجر --> Stranger
بوتنشيال --> Potential
اكوردينج --> According
هيرتبريك --> Heartbreak
البايمنت --> El Payment
الأنيميا --> El anemia
يونيكورن --> unicorn
سينماتيك --> Cinematic
اوبراتيف --> Operative
ديتيكتيف --> Detective
البيرسون --> El PERSON
فورايفرر --> Forever
ميليجرام --> milligram
مينتالتي --> mentality
سوسيولجي --> Sociology
ميجافولت --> Megavolt
فيبراتور --> vibrator
اكستريور --> Exterior
بيرفيكتت --> perfect
ساسبنديد --> suspended
الفاندوم --> El fandom
ناتشورال --> Natural
نمبر وان --> number one
جيطاريست --> Guitarist
الوركينج --> El working
مورنيينج --> Morning
بيرمنانت --> permanent
ليجيندري --> legendry
ليتيرالى --> Literally
لوجيستكس --> Logistics
انجينيير --> engineer
ايفرجرين --> evergreen
باتلفيلد --> battlefield
الفيتينج --> Fitting
الفروزين --> El Frozen
دايناميت --> dynamite
الترينير --> El Trainer
ليرنيينج --> learning
بروبيلين --> propylene
يورسيلفز --> Yourselves
الهيدسيت --> El Headset
ماكسيمام --> maximum
باي بولر --> bi Polar
الباكينج --> El Baking
ستايلينج --> Styling
الديفولت --> El Default
ابلفتينج --> Uplifting
ماركتيير --> marketer
الفينانس --> El Finance
المييتنج --> El meeting
بروجريسف --> Progressive
وفريندلي --> W Friendly
بوليجراف --> Polygraph
الهيليوم --> El helium
بريزدينت --> President
كونفرميد --> Confirmed
بارادوكس --> Paradox
اكواليتي --> Quality
مورنينجج --> Morning
اكورديون --> accordion
النيورال --> El Neural
كونفيرمد --> Confirmed
سوشياليز --> Socialize
ريجاردلس --> Regardless
الارتيست --> El Artist
اوكسيچين --> Oxygen
رياليستك --> Realistic
اودورانت --> Odorant
واندرفول --> Wonderful
ترانسليط --> Translate
هيدروجيل --> hydrogel
