هيدرومتر --> hydrometer
بايولوجي --> Biology
سينسيتيڤ --> Sensitive
هولوكوست --> Holocaust
اوكساليك --> oxalic
ماريونيت --> marionette
بايولوچي --> Biology
الفيتنيس --> El Fitness
استانليس --> stainless
اللاتيكس --> El latex
البوليمر --> El polymer
اوفينسيف --> Offensive
ماجيستيك --> Majestic
الفورمال --> El Formal
ديجيتاال --> digital
باثولوجي --> pathology
ساسبيندد --> suspended
استروجين --> estrogen
البيجمنت --> El Pigment
بيرفكتلي --> Perfectly
البيولجي --> El biology
تيليباثي --> Telepathy
لايتنينج --> Lightning
الاسيتات --> El acetate
ستيودينت --> student
كونتيكست --> CONTEXT
بريكفاست --> breakfast
تيرمينال --> terminal
السيتينج --> El Setting
آي لاينر --> eyeliner
موونلايت --> moonlight
ميليتارى --> military
ترموميتر --> thermometer
ساتسفايد --> Satisfied
موليكلار --> molecular
هيموستات --> Hemostat
انيماتور --> Animator
الهوستري --> histry
برمنجنات --> permanganate
السسبيند --> El suspend
سكوربيون --> scorpion
ديريكتور --> director
بروتكتور --> Protector
ريليڤانت --> Relevant
سولاريوم --> Solarium
بريكدوان --> Breakdown
هوسبيتال --> Hospital
الهورمون --> El hormone
ماجنيتيك --> Magnetic
ماركتينق --> Marketing
بوينتليس --> pointless
وركييننج --> working
فليرتينج --> flirting
اتتيتيود --> Attitude
الديماند --> El demand
داياجرام --> Diagram
السنسوري --> El sensory
النورمال --> El normal
داارلينغ --> Darling
ميجاوايت --> megawatt
نبيوليزر --> nebulizer
دياجنوزس --> diagnoses
لونلي مى --> lonely me
السيرفير --> El server
الفاميلي --> El family
اوريجنال --> original
إستروجين --> estrogen
ديستروير --> Destroyer
ولوكيميا --> W leukemia
تاكلينج --> tackling
ريسيفير --> receiver
بافيديو --> Video
أنسولين --> Insulin
سربرايس --> Surprise
برافووو --> Bravo
بولوجيه --> biology
وردبلاي --> wordplay
ووركينج --> working
ماندالا --> mandala
سبورتنح --> sporting
ميداليه --> Medal
سبيسيفك --> SPECIFIC
ريتاردد --> retarded
تتوريال --> tutorial
ميستريي --> Mystery
ديليفرى --> delivery
وسيجنال --> Signal
فمينيست --> feminist
سنترالا --> Central
التربون --> Tarpon
بورتريه --> portrait
مينيرال --> Mineral
سباركيل --> Sparkle
افيلابل --> available
البالون --> balloon
فااينال --> final
بايكينج --> Baking
كالسيوم --> Calcium
دينايال --> denial
نيجاتيڤ --> negative
برينسيس --> Princess
بيرسويت --> Pursuit
دوبليكس --> Duplex
فيوريوس --> Furious
بيتززاا --> pizza
فيدبااك --> Feedback
اتيرنتي --> Eternity
سوفونير --> Souvenir
برووفيل --> Profile
لمارينا --> Marina
ميدالية --> Medal
وسترونج --> strong
انتريست --> interest
ترايدنت --> trident
سلفوريك --> sulfuric
جيمبلاي --> Gameplay
سيتيزنس --> Citizen
كونتينت --> Content
بروفايل --> Profile
سكيورتي --> Security
الباندا --> panda
بوبكورن --> popcorn
ريسبكيت --> Respect
هاندميد --> handmade
التوراه --> Torah
تيليفون --> Telephone
براوفوا --> Bravo
تسونامي --> tsunami
فاكتوري --> Factory
وترملون --> Watermelon
جيولوجي --> geology
ااسمارت --> smart
إليجانس --> Elegance
ديلفيرى --> Delivery
هوليداى --> holiday
هااكينج --> Hacking
أسبستوس --> asbestos
ريتاردت --> retarded
بوكمارك --> Bookmark
دياجرام --> Diagram
هاوسينج --> housing
برونزيه --> Bronze
باكوورد --> backword
