بسبويلر --> spoiler
الساونا --> sauna
إسبستوس --> asbestos
سينتروم --> Centrum
موررننج --> Morning
الريسيت --> Receipt
الهيكسا --> Hexa
ترافيلر --> Traveler
سترليني --> sterling
سبرينكل --> Sprinkle
تريسيكل --> motorcycle
هاندماد --> handmade
استاتيس --> status
امبريلا --> Umbrella
ايديتور --> editor
ترايننج --> training
سبونسور --> Sponsor
سيليكون --> silicon
كونترول --> control
ريسبونس --> response
اكسباند --> Expand
توربينة --> turbine
فيستڤال --> Festival
ديابيتس --> Diabetes
ديالوجا --> Dialogue
إفينينج --> Evening
مونتاجا --> montage
لانيميا --> Anemia
بلانديش --> Blandish
انسبيرد --> Inspired
ساموراي --> samurai
نيترونى --> neutron
بهستريا --> hysteria
الالبوم --> album
فارييتى --> Variety
ديبريسد --> depressed
فلامنغو --> flamingo
ماريونت --> marionette
لوجيكال --> Logical
بريميام --> Premium
برستيجه --> Prestige
بستوديو --> studio
بوليسية --> police
كانجارو --> kangaroo
استايلي --> Style
أندرويد --> Android
ارتيسيت --> Artist
إسبايسي --> Spicy
نورمالل --> normal
انيمياا --> anemia
ليموناً --> lemon
تيلقرام --> Telegram
اوبنينج --> Opening
سوسايتي --> Society
البينكي --> Pinky
فايناال --> final
ايربلين --> Airplane
باسبورك --> Passport
بيرسينق --> piercing
الوورلد --> world
باكويرد --> Backward
يونيتيد --> United
ديليفري --> Delivery
اندريود --> Android
مايكينج --> making
ايفرمور --> Evermore
بورنزيه --> bronze
بارامتر --> parameter
ساركوما --> sarcoma
واتس اب --> whatsApp
كاستينج --> casting
باسيفيك --> Pacific
ينيفورم --> Uniform
لانجيري --> Lingerie
ميتريال --> Material
بنزيدين --> benzidine
ستيديوم --> stadium
كارتوون --> cartoon
ترانزيت --> Transit
لويالتي --> loyalty
ديسكريت --> Discrete
فرونتال --> Frontal
بارتينر --> partner
أفورجيت --> Forget
هاندبول --> handball
راديكال --> Radical
سيميستر --> semester
ديناصور --> dinosaur
فلورايد --> fluoride
فالنتين --> Valentine
ارتتيست --> artist
إكسبيرت --> expert
جالاكسي --> Galaxy
مودلينج --> Modeling
فانيليا --> vanilla
نورماال --> normal
ديستانس --> Distance
درامتيك --> Dramatic
فيدرالى --> Federal
تلجيرام --> Telegram
كلادينج --> Cladding
أستوديو --> studio
أنفستور --> Investor
بوبولار --> popular
فايميلي --> family
موسيقية --> music
ايماجين --> Imagine
ارتييست --> ARTIST
اسيمبلي --> assembly
كاراميل --> Caramel
سيرافيم --> seraphim
كلارينت --> clarinet
ليترالى --> literal
ابسلوتي --> Absolute
بريستيج --> Prestige
بنيفيتس --> Benefit
كيلوواط --> kilowatt
ويركينج --> working
فلورانس --> Florence
يسترداي --> Yesterday
موستارد --> mustard
ڤيتامين --> vitamin
إكسبلور --> explore
فانتاسي --> Fantasy
ريالتتي --> Reality
ديليوشن --> Dilution
هستيريا --> hysteria
كواليتي --> Quality
ماركتنج --> Marketing
هيسرتيا --> Hysteria
سيليكات --> silicate
فيتامين --> vitamin
اسبايسي --> Spicy
سينترال --> Central
برستيجي --> My prestige
تورنيدو --> tornado
ووركشوب --> Workshop
ڤارييتي --> Variety
كومبلكس --> complex
ادورابل --> adorable
فلامنجو --> flamingo
موبآيلي --> mobile
ڤانيللا --> Vanilla
