إنترفال --> Interval
ريفرينس --> Reference
جوديشال --> Judicial
لوجيستك --> logistic
مورنينچ --> Morning
ستانليس --> Stainless
جينيريك --> Generic
باردايس --> Paradise
اسباركل --> Sparkle
ديناسور --> dinosaur
جيلوجيا --> geology
فوريڤير --> Forever
هارڤيست --> Harvest
دينامكس --> dynamics
اوريجنل --> original
مونولوج --> monologue
سبسيفيك --> Specific
ديجيتال --> digital
ماينينج --> Mining
بروسيزس --> prosthesis
ديسبلاي --> Display
ريستارط --> Restart
ريميمبر --> Remember
بريفيوم --> Prefium
ملينيوم --> Millennium
وندرفول --> Wonderful
أكسبورت --> Export
الأنجري --> Angry
توتاالي --> Totally
بورترية --> portrait
رافيولي --> ravioli
ماتينيه --> matinee
براافوا --> Bravo
وودسايد --> Woodside
بيرذداي --> birthday
كابيتال --> Capital
برتوكول --> protocol
هابيتات --> Habitat
أناتومي --> Anatomy
كونسيرت --> Concert
جينيورز --> Juniors
بوليستر --> polyester
بيرثداي --> birthday
فستيڤال --> Festival
بورسلين --> porcelain
فيلوستى --> Velocity
ستيوبيد --> stupid
كولونيل --> colonel
سينيرچي --> Synergy
سيمينار --> seminar
اللوجوس --> logos
نيجاتيف --> negative
بيبروني --> pepperoni
تيلجرام --> Telegram
ادفيزور --> advisor
يونيفرس --> Universe
جلسيرول --> glycerol
ڤافوريت --> Favorite
اسبرينه --> aspirin
ترايينج --> Trying
مانيوال --> Manual
ريموتلي --> remotely
تلجراام --> Telegram
تيتنيوم --> titanium
تيرماتك --> Termatic
مللميتر --> millimeter
نيوترال --> Neutral
بانورما --> panorama
هسيتوري --> history
استديوم --> stadium
تروبيكل --> Tropical
استاندر --> standard
إنسولين --> Insulin
باراديس --> Paradise
روزماري --> rosemary
تيبيكال --> Typical
فيمينست --> Feminist
اوفردوس --> overdose
ديبندنس --> Dependence
آمونيوم --> ammonium
جالاكسى --> Galaxy
ديفنتلي --> Definitely
مريونيت --> marionette
والكوير --> Walker
ليسوزيم --> Lysozyme
وايتينج --> Waiting
توماتوز --> tomatos
اتيتيود --> Attitude
اينجووي --> enjoy
كارنفال --> carnival
هيستريا --> hysteria
ماسيترو --> Maestro
بنسيلين --> penicillin
بريلينت --> Brilliant
استاارت --> start
بارنويا --> paranoia
ماجيستك --> Majestic
كرياتيف --> Creative
أكسبريس --> Express
ميكستشر --> Mixture
باورفول --> Powerful
اوردنري --> Ordinary
كارافان --> caravan
رايدينج --> Riding
هراسمنت --> harassment
فيلترنج --> filtering
ترادينج --> Trading
ترليوون --> trillion
برجماتي --> pragmatic
بيرفيوم --> Perfume
نابليون --> Napoleon
كايبورد --> keyboard
بريسينج --> piercing
هولدينق --> holding
بلايباك --> playback
ديسلايك --> dislike
دارلينق --> Darling
فاينالى --> finally
براوفوو --> bravo
همبورجر --> hamburger
بيلوجيا --> biological
رزيدينت --> Resident
ريبلايي --> Reply
سليبينج --> sleeping
سلفونيك --> sulfonic
دليفيري --> Delivery
برسيتيج --> Prestige
تريبلكس --> triplex
كنجاروو --> Kangaroo
موريننج --> Morning
ديناميت --> dynamite
فيفوريت --> Favorite
بيراميد --> pyramid
سوبرمان --> superman
باسبوره --> His passport
هارموني --> Harmony
اسبريين --> aspirin
ايروبيك --> Aerobic
كيروسين --> kerosene
تراينجل --> Triangle
ريبورتر --> reporter
باكهاند --> backhand
ساندويش --> sandwich
