اجنوستك --> Agnostic
فيمنيزم --> feminism
انيميتد --> Animated
تويلايت --> Twilight
وتربروف --> Waterproof
مركتينج --> Marketing
السيروم --> El serum
دليفرري --> Delivery
بلياردو --> billiard
البويلر --> the boiler
جورنالا --> Journal
هارتليس --> heartless
ريميندر --> Reminder
الألارم --> Alarm
ستارشيب --> starship
بريسليس --> Priceless
فليكسبل --> Flexible
الفودكا --> vodka
بيرسينت --> precent
وايرليس --> wireless
الجيبرا --> Algebra
بريستيچ --> Prestige
اكسبريس --> Express
ماتشينج --> Matching
هوليداي --> Holiday
باسبوور --> Passport
سوشيالي --> socially
باسوورد --> password
وويكيند --> weekend
سوفينير --> Souvenir
ماركتير --> marketer
سكليتال --> Skeletal
جورنـال --> Journal
وييكإند --> weekend
واتشينج --> Watching
اسموكنج --> smoking
استوكنج --> El stocking
اينفينت --> Infinite
سيناريو --> Scenario
جيتارست --> guitarist
توماتوا --> tomato
أكستريم --> Extreme
فاينالل --> Final
بلاتنيم --> platinum
الليمون --> El lemon
هيلبينج --> helping
لايفليس --> Lifeless
فرييدوم --> Freedom
هاندباج --> handbag
التوييت --> El Tweet
بيرفيكت --> perfect
باربكيو --> barbecue
وارمينج --> Warming
ميدسنال --> medicinal
ربيبورت --> Report
فافورتت --> Favorite
ديركتور --> director
إكسبريس --> Express
ميوتوال --> Mutual
بلوبيرد --> bluebird
ديلڤيري --> Delivery
فيدرالي --> Federal
واتيڤير --> Whatever
سبورتنج --> Sporting
هابيننج --> happening
چينيرال --> General
كومبلين --> Complain
بلايبوي --> playboy
روتينية --> routine
سلينيوم --> selenium
وتروللي --> trolley
كوابييس --> nightmares
واتميتر --> wattmeter
سنووايت --> Snowwhite
برافووة --> Bravo
اللويال --> loyal
ماجنيتو --> Magneto
ردياتير --> radiator
مالاريا --> malaria
اكسبورت --> export
كيبوورد --> keyboard
ابستريم --> upstream
فايكينج --> Viking
جاللكسي --> Galaxy
بيجيننج --> Beginning
كوميدين --> comedian
بكيبورد --> b keyboard
هاميستر --> hamster
ريلااكس --> Relax
سيكشوال --> Sexual
تولكينج --> Talking
براففوو --> bravo
بلاستيك --> plastic
سبيسيال --> special
بوتاتوس --> Potatoes
ستاشيون --> station
فورايفر --> forever
ويتينجج --> Waiting
هوستينج --> Hosting
ضارلينج --> Darling
الألبوم --> El album
ميرمايد --> Mermaid
غوريللا --> gorilla
دليفيرى --> Delivery
باسوررد --> password
ستيرويد --> steroid
برووجرس --> Progress
شارمينج --> Charming
جولوجيا --> geology
ساسبينس --> Suspense
رياليتي --> Reality
جلاجكسي --> Galaxy
ايمرالد --> Emerald
باسبورت --> Passport
هالوجين --> halogen
سابليير --> supplier
توموروو --> Tomorrow
ميستريس --> Mistress
اسسيتنت --> assistant
بريشيوس --> Precious
برسونال --> personal
هيستريه --> hysteria
اكسبلور --> explore
جيلاتين --> Gelatin
انونيمس --> Anonymous
إسترونج --> strong
فييلينج --> Feeling
ميليمتر --> millimeter
نيوزروم --> Newsroom
كيراتين --> Keratin
بوسيتيف --> Positive
برانسيس --> Princess
كوريدور --> corridor
ديودرنت --> Deodorant
فلكلورا --> folklore
بووفوون --> Buffoon
أمبريال --> Imperial
بارتنرر --> Partner
باصوورد --> password
ملليمتر --> millimeter
فرتشوال --> virtual
امازينج --> amazing
سوسياتي --> society
