يونفيرس --> Universe
كاراتية --> Karate
كرياتين --> creatine
متفيروس --> virus
روتايشن --> rotation
هاازارد --> Hazard
بيولوچي --> Biology
استورري --> story
كالاكسي --> Galaxy
انسولين --> Insulin
السونار --> El sonar
الرادار --> El radar
ديستركت --> district
انترنال --> Internal
أيماجين --> Imagine
البرينت --> El print
ستايرين --> styrene
باركينج --> parking
ألسونار --> El sonar
سييكينج --> Seeking
بينجوين --> Penguin
جلااكسي --> Galaxy
فلكلوري --> folkloric
سميترية --> symmetry
فاامووس --> Famous
برونزية --> Bronze
مكسيمام --> Maximum
أورجنال --> Original
بوكسينج --> Boxing
اينيرجي --> Energy
بروتيين --> protein
ماريناا --> Marina
بروتينا --> protein
سيلفيوم --> silphium
فانتازي --> fantasy
برااففو --> Bravo
كويلينج --> coiling
هامبرجر --> hamburger
سينستيف --> Sensitive
رياكتيف --> Reactive
دينتيست --> dentist
كريستال --> Crystal
إنترنال --> INTERNAL
هيستوري --> history
رومانسى --> romantic
هيستيري --> hysterical
وديجتال --> W digital
فاينللي --> FINALLY
ديفلوبر --> developer
تايمينج --> Timing
ابنورمل --> Abnormal
فرتيكال --> Vertical
ادفانسد --> advanced
كييبينج --> keeping
بيلدينج --> building
ستايلنج --> Styling
ماكسيمم --> Maximum
كوانتوم --> Quantum
بوتاسيم --> Potassium
بيهايند --> Behind
بريجننت --> Pregnant
رياليتى --> Reality
لاندينج --> Landing
تيرمنال --> terminal
بروجريس --> progress
ريجردلس --> Regardless
فورافير --> Forever
أورجينل --> original
هارمونى --> Harmony
فولنتير --> Volunteer
الدايلي --> El Daily
دليڤيري --> Delivery
بوندينج --> Bonding
اسبورتس --> sports
سابتيتل --> subtitle
بايونير --> Pioneer
اوكسجين --> oxygen
اكسيتيد --> Excited
ايندليس --> Endless
اناتومى --> anatomy
تريتمنت --> treatment
رايتينج --> writing
ديدلاين --> Deadline
يورسيلف --> Yourself
ديسوردي --> Disorder
دايجيست --> Digest
فريندلى --> Friendly
ميلامين --> Melamine
ماكسميم --> Maximium
شامبيون --> Champion
بوينتلس --> pointless
ليفتينج --> Lifting
افترنون --> afternoon
ميليتري --> Military
مانجمنت --> management
بيرستيج --> Prestige
ريلاتيد --> Related
ترينينج --> training
ويتيينج --> Waiting
استتووب --> stop
ادفانتج --> Advantage
بيرتداي --> birthday
ساتسفيد --> Satisfied
ميديتيت --> Meditate
اتتيتود --> Attitude
ستنرونج --> Strong
ارجينال --> original
كينقدوم --> Kingdom
باراديز --> Paradise
ليتراري --> Literary
تارجيتد --> Targeted
السبيكس --> El Spex
وفييلنج --> Feeling
ريسنتلي --> Recently
برستييج --> prestige
هيدريتد --> hydrated
انفنيتي --> infinity
مولدينج --> Molding
إنتريست --> interest
بوردينج --> boarding
لاينينج --> Lining
اوتومات --> Automate
سيتيزين --> Citizen
سيندروم --> Syndrome
أنفينتي --> Infinity
أوبنينج --> Opening
كوانتتي --> Quantity
نيتوورك --> Network
اندستري --> industry
مينيمال --> Minimal
ريونيون --> reunion
جولدفيش --> Goldfish
رييلاكس --> Relax
ديسبنسر --> Dispenser
استريمر --> streamer
بروبليم --> problem
بوليتيك --> politic
ميتافور --> metaphor
ديجستيف --> Digestive
لانجويج --> Language
سيلفستر --> sylvester
ستريمنج --> Streaming
نجياتيف --> Negative
