كوميدان --> comedian
الفرونت --> El Front
ريلاكسس --> Relax
الهيرتز --> El hertz
فيمنيست --> feminist
انيوااي --> Anyway
اسبويلر --> spoiler
سينيوور --> Senior
سلايتلي --> Slightly
موورننج --> Morning
زوولوچي --> zoology
بروبرتي --> property
هيستورى --> history
اكسبيرت --> expert
كومبليت --> complete
لانجويچ --> language
ريجونال --> Regional
بيبولار --> bipolar
الرويال --> El Royal
ترنسفير --> transfer
سينسيتف --> sensitive
فيبروما --> fibroma
دايفينج --> Diving
ماينديد --> Minded
فيمنتست --> feminist
سبيكترم --> Spectrum
التيكست --> El Text
سترينجر --> stranger
فريندلي --> Friendly
كينجدوم --> Kingdom
سكورينج --> Scoring
ديستيني --> Destiny
البارتي --> El party
بيرسونا --> Persona
هكساجون --> hexagon
إنستانت --> instant
كولاجين --> collagen
دارلينج --> Darling
شيفتينج --> Shifting
اراتيست --> Artist
الالارم --> El Alarm
آنفريند --> Unfriend
إسموكنج --> smoking
سريوسلي --> Seriously
بيانيست --> pianist
الديلاي --> El Delay
سليبرتي --> Celebrity
ميتاليك --> metallic
ستروبري --> Strawberry
اتومبيل --> Automobile
ريوستات --> rheostat
ايرجينت --> Urgent
ميدلاند --> Midland
بنتونيت --> bentonite
مونوتون --> Monotone
جراندما --> Grandma
ميلانين --> melanin
فيستفال --> Festival
تريدينج --> Trading
إنفنيتي --> Infinity
سايلينت --> Silent
بارتندر --> bartender
فانتاسى --> Fantasy
الفليرت --> El flirt
ماجستيك --> Majestic
اناتومي --> anatomy
فلورينس --> Florence
ريتشوال --> Ritual
اوفنديد --> OFFENDED
افينينج --> Evening
بينيفيت --> Benefit
اوفرهيد --> Overhead
دريسينج --> Dressing
ديسكونت --> discount
درايفنج --> driving
ريلايشن --> Relation
انافورا --> Anaphora
براكتيس --> practice
سامبلنج --> sampling
كومديان --> comedian
أسبونسر --> Sponsor
اورجنال --> original
هيلبفول --> helpful
ايدنتتي --> Identity
بريزونر --> Prisoner
استيلنج --> Styling
انفيرتر --> inverter
بوكينيج --> Booking
ماونتين --> Mountain
سباينال --> Spinal
ايندينج --> Ending
أولتيمت --> Ultimate
اورجينل --> original
ريفيرنس --> Reference
فروز ان --> Frozen
إيندينج --> Ending
ستايلست --> stylist
ديسباتش --> Dispatch
هانتينج --> Hunting
فريزينج --> Freezing
رمايندر --> reminder
إكسبورت --> export
فوكاليز --> Vocalize
سموكينج --> smoking
جنتلمان --> gentleman
فاممووس --> Famous
ارتيستت --> Artist
نييدليس --> Needles
بميتينج --> b meeting
انتريور --> Interior
سبراايز --> surprise
أدابتيف --> adaptive
ستاندنج --> Standing
فاراداى --> Faraday
توويليت --> Twilight
جليسرين --> glycerin
ديچيتال --> digital
فولوينج --> following
امبيرور --> Emperor
ميسكاست --> miscast
امبلفير --> amplifier
فاراداي --> Faraday
استرونج --> strong
هوسبتال --> Hospital
كادميوم --> Cadmium
بيرسينج --> piercing
امونيوم --> ammonium
بكتيريا --> bacteria
بريكينغ --> breaking
رايسيست --> RESIST
جلوكوما --> glaucoma
مايسيلف --> Myself
بوسيتيڤ --> Positive
مونيتور --> Monitor
اميزينج --> amazing
سوربريز --> Surprise
واتيفير --> Whatever
موديلنج --> Modeling
ناشونال --> National
بيوتيفل --> beautiful
أدفانسد --> Advanced
وانبلوك --> W Unblock
مورنينح --> Morning
