بريكينج --> breaking
بينفيتس --> Benefits
الديرما --> El derma
ماتريكس --> Matrix
سترونجج --> strong
سرفايفر --> Survivor
ديفيلوب --> Develop
ريكوردر --> recorder
بوزيتيف --> Positive
أمبريلا --> Umbrella
لوكيميا --> leukemia
بريكننج --> breaking
ديبندنت --> Dependent
نمبر تو --> number two
بتروليم --> Petroleum
إمبوستر --> imposter
ريسبيكت --> Respect
اسبستوس --> asbestos
أمونيوم --> ammonium
بريميوم --> Premium
هوتبوكس --> Hotbox
بروديوس --> Produce
انيوايز --> Anyways
بنكرياس --> pancreas
فوريفرر --> Forever
توليرنس --> Tolerance
وفاميلي --> W family
ليبستيك --> Lipstick
كونسيرن --> Concern
إيديتور --> editor
فيسيتور --> visitor
أوبسرفر --> Observer
سبيشيال --> special
ناتشرال --> natural
ميدنايت --> midnight
سنتميتر --> centimeter
سكانينج --> Scanning
كلينينج --> cleaning
بارافين --> paraffin
هومليسس --> homeless
سيلبرتي --> Celebrity
انالسيز --> Analysis
نيوترون --> neutron
ريليتيد --> Related
أنفريند --> Unfriend
سكالبنج --> Scalping
فاڤوريت --> Favorite
بيتويين --> between
أسترونج --> strong
ريلاتبل --> Relatable
ريتريفر --> retriever
ريفليكت --> Reflect
ماكسيما --> Maxima
ريكويست --> Request
انوسميا --> Anosmia
كونفيرم --> Confirm
إيفنينج --> Evening
اتليتيك --> Athletic
سمووثلي --> smoothly
كومبوند --> compound
ديزاستر --> Disaster
بروجيكت --> Project
السبيرم --> El sperm
ريفلاكس --> Reflex
ريفليكس --> Reflex
اليجانت --> elegant
تالنتيد --> Talented
هيلبليس --> helpless
ريجيستر --> Register
ريكوفري --> recovery
فاينالي --> finally
ماتريال --> Material
هوسبيتل --> Hospital
أبستريم --> Upstream
سليستين --> Celestine
انجنيير --> Engineer
فيلينيج --> Feeling
ديفايند --> Defined
ساسبيند --> Suspend
سايزينج --> sizing
ميلجرام --> milligram
وورمينج --> worming
رندوملى --> Randomly
انفينيت --> Infinite
فيمنسيت --> Feminist
ريبلالي --> Reply
فيرشوال --> Virtual
كيلووات --> kilowatt
بريسدنت --> President
هولدينج --> Holding
رستوران --> restaurant
هارمونی --> Harmony
فيجترين --> Vegetarian
بيوتفول --> Beautiful
ثينكينج --> Thinking
ارجومنت --> Argument
فورميلا --> Formula
أميلويد --> amyloid
فورماال --> Formal
نوتيفاي --> Notify
سينتاكس --> Syntax
ليجندري --> Legendary
ارتستيك --> Artistic
ديفرينس --> Difference
سيجاريت --> Cigarette
ماجيكال --> Magical
بايبولر --> Bipolar
فاستينج --> Fasting
انفينتي --> infinity
كومفورت --> Comfort
ريستارت --> restart
برادايس --> Paradise
ترافيرز --> Traverse
ثانكفول --> Thankful
جراوندد --> Grounded
مورنينق --> Morning
استرويد --> steroid
كروميوم --> Chromium
فاينانس --> Finance
دانسينج --> Dancing
كينتيكس --> kinetics
ريلاكسد --> Relaxed
ريموتلى --> remotely
انجينير --> engineer
ريسستنس --> resistance
فييدباك --> Feedback
مديسنال --> medicinal
فاميليي --> family
ماجنتيك --> Magnetic
بروتيكت --> protect
فيزيتور --> visitor
سكيتينج --> Skating
انيثينج --> Anything
ميديكال --> medical
كونسيبت --> Concept
ريجسترى --> registry
فافوررت --> Favorite
ديبوزيت --> Deposit
فيليينج --> Feeling
ابيتيزر --> appetizer
اوارنيس --> Awareness
صوبرمان --> Superman
جليسرول --> glycerol
