فايتينج --> fighting
دياموند --> Diamond
ديفيندر --> Defender
جلاوكوس --> Glaucous
ماراثون --> marathon
كريمنال --> Criminal
هستامين --> histamine
بريكفست --> breakfast
هابنينج --> happening
سينكينج --> Thinking
ستيودنت --> Student
سيكرتلي --> secretly
الليميت --> limit
ديفولوب --> Develop
انجولار --> Angular
فوريفير --> Forever
هاندسوم --> Handsome
باكبون --> Backbone
غراهام --> Graham
كوبالت --> cobalt
دويتوا --> duet
الريست --> Rest
اللودو --> ludo
مينتال --> mental
يإنجوي --> enjoy
سبووني --> leave me
تايلنت --> Talent
لفليكس --> flex
ديجتال --> digital
هورينج --> Whoring
موفينج --> moving
برنزية --> bronze
ستيرنج --> Steering
تيستسي --> tasty
تارتيج --> tart
جيبونة --> jupe
ترييند --> Trend
هوسبيس --> hospice
ميلتري --> Military
ستروكر --> Stroker
انونمس --> Anonymous
جيرمني --> German
اييرون --> Iron
بانانا --> Banana
فورمات --> Format
ساتليت --> Satellite
بلكيلو --> kilo
إسبراي --> spray
سبيورت --> sport
فورجيت --> Forget
ليڨينج --> Living
سويشال --> social
بريديج --> Bridge
السولو --> solo
جونيور --> Junior
تريينج --> training
اوفرلي --> Overly
ديرماا --> Derma
اوتفيت --> outfit
رينبوو --> Rainbow
بارتنر --> partner
انيرجي --> Energy
بولينج --> bowling
بلوكنج --> Blocking
اسبووت --> Spot
ألكيلو --> kilo
بلازما --> plasma
براديس --> Paradise
استوري --> story
كاميرا --> Camera
مونيكر --> moniker
بريفكس --> prefix
فايندر --> Finder
برستيج --> Prestige
بروتين --> protein
سيترين --> citrine
ادابتر --> adapter
فورقيت --> Forget
ريبورت --> Report
تارجيت --> target
ادميرر --> Admirer
باسورد --> password
فورينر --> foreigner
كراتيه --> karate
توميتو --> tomato
سيسزون --> season
سايلنت --> Silent
مانجوا --> mango
فولتاج --> Voltage
اوتيزم --> autism
دوكاتو --> ducato
فيولين --> Violin
ترمنال --> terminal
فرابيه --> frappe
اوونلي --> only
سبورتى --> sporty
تااكسي --> taxi
تويتتر --> Twitter
تايمنج --> Timing
مديديا --> media
ماكينج --> making
فيلينج --> Feeling
ايجينت --> Agent
استارر --> star
سنترال --> Central
هومليس --> homeless
تريندج --> trending
ليرنيج --> learning
بوسيبل --> Possibleq
سينسور --> sensor
تلجرام --> telegram
كانفاس --> canvas
سترونج --> strong
انديكس --> Index
كانجرو --> kangaroo
فاندوم --> fandom
ديفاند --> Defined
ريسورت --> Resort
سنستيف --> Sensitive
تهاندل --> handle
سنسيتف --> Sensitive
اوتينج --> outing
باركنج --> Parking
ريبروت --> Report
بروميس --> Promise
ترينيج --> training
مونتاج --> montage
كراتية --> Karate
أنيميا --> anemia
ملاريا --> malaria
راديوو --> radio
نايسلي --> Nicely
انيميا --> anemia
ترليون --> trillion
منتالي --> mentally
ليكويد --> Liquid
مارفيل --> Marvel
سندروم --> Syndrome
ديفندر --> Defender
سبورتج --> Sporting
فيدييو --> video
بروفيل --> Profile
جالكسي --> Galaxy
