تريلير --> Trailer
ستريبر --> striper
موسيقى --> music
ميموري --> memory
ديجنتي --> Dignity
سبرينج --> Spring
مينينج --> Mining
دينامو --> dynamo
وبيدرو --> Pedro
الآمين --> Amen
أسبليت --> Split
سنيورر --> Senior
وندرفل --> wonderful
ماكينغ --> making
توتالة --> Total
سيستيم --> system
سمبلكس --> simplex
دايفنج --> Diving
برينتر --> Printer
سيانيد --> cyanide
ميتينج --> meeting
ميكرون --> micron
صوديوم --> sodium
باكينج --> Baking
تواليت --> toilet
سبيلنج --> Spelling
رستارت --> restart
رسيبكت --> respect
سيجنال --> Signal
استريو --> stereo
سكريبت --> script
راندوم --> Random
ريتورت --> retort
ليفينج --> Living
ريكورد --> record
فرندلي --> Friendly
ريسترت --> Restart
هيدسيت --> headset
برينتد --> Printed
سوسيال --> social
برايسد --> Priced
سايينج --> saying
رايتنج --> rating
بروبلم --> problem
سيكينج --> Seeking
ريبلاى --> Reply
أنيرجي --> Energy
داييتت --> Diet
ايرجنت --> Argent
چونيور --> Junior
برافوو --> Bravo
سبايكي --> Spiky
سيمبول --> symbol
بماينس --> Minus
دليفري --> Delivery
باتمان --> batman
بروليه --> brulee
چاجوار --> Jaguar
سيلندر --> cylinder
استارت --> start
برنسيه --> Princess
بررافو --> Bravo
أنيمال --> animal
هوسبتل --> Hospital
مارڤيل --> Marvel
سيكتور --> Sector
جينيور --> Junior
نوليدج --> knowledge
ميسترو --> Maestro
مركتنج --> marketing
بيوتيك --> Biotic
همبرجر --> Hamburger
ميسينج --> missing
توريست --> Tourist
بروسسر --> Processor
بووينت --> point
البلاي --> play
موممنت --> Moment
كلسيوم --> calcium
بوكسنج --> Boxing
استاند --> stand
ريسيبي --> Recipe
أكسترا --> extra
بوكينج --> booking
إنيميا --> anemia
ديفينس --> Defense
ستارتر --> starter
منولوج --> monologue
سويينج --> swinging
إنيرجي --> Energy
إستاند --> stand
أستديو --> studio
ميلودي --> Melody
بادجيت --> budget
سفااري --> safari
بوسطون --> Boston
فيليمة --> film
سبونجي --> Spongy
إكسبيل --> expel
سوفييت --> soviet
سناريو --> scenario
هابينس --> happiness
لاكتام --> lactam
سبيريت --> Spirit
سترايك --> strike
دروباك --> drawback
بلدوزر --> bulldozer
سادنيس --> Sadness
إينجوي --> enjoy
سنيوور --> Senior
سينماا --> cinema
اليمون --> lemon
سمارات --> Smart
ريميكس --> remix
بروكسي --> proxy
دولارر --> dollar
ايررور --> Error
سمينار --> seminar
سبليتر --> splitter
سويتيي --> Sweetie
هوتنيس --> Hotness
جنيرال --> General
دنتاال --> dental
ترافيل --> Travel
موبايل --> Mobile
ريدينج --> Reading
سافاري --> safari
تيستنج --> Testing
ليڤينج --> Living
براديو --> b radio
نيجاتف --> Negative
الأوتو --> El Auto
رميمبر --> Remember
تويتير --> Twitter
بـرايا --> out of me
سوليتر --> solitaire
هوتايل --> hotel
وهارتس --> Hearts
تالنتد --> talented
تروللي --> trolley
سافانا --> savanna
ديفرنت --> different
سابواي --> subway
