تيستير --> tester
سموكنج --> smoking
فلوينت --> fluent
سيمبلي --> Simply
أنيواي --> Anyway
بييليف --> belive
هومورك --> Homework
داتينج --> Dating
نورمال --> normal
ايفينت --> Event
فافورت --> Favorite
فريندد --> Friend
فيچوال --> visual
ميديسن --> Medicine
ماستزر --> masters
فاميلي --> family
اتيتود --> attitude
إينرجي --> Energy
اكسترا --> extra
اسمارت --> smart
ميدسين --> Medicine
سترونغ --> strong
سيمبلى --> Simply
ريفرنس --> Reference
ستريمر --> streamer
اسمبلي --> Assembly
سوفتنس --> Softness
بوستنج --> Posting
انيجما --> Enigma
بروسيس --> process
بلانكت --> Blanket
فلوريد --> fluoride
بريميم --> Premium
تيكسست --> text
اكسينت --> Accent
فرووزن --> Frozen
استرنج --> strong
جريتنس --> Greatness
ديفينت --> Definite
ريسفير --> Receiver
ريسورس --> Resource
ميديام --> Medium
ديزيرت --> desert
هورمون --> hormone
جيلوجي --> geology
ديفولت --> Default
توكسيك --> Toxic
سبرايز --> suprise
توتالي --> Totally
دينتست --> dentist
بلوكاج --> blockage
ريبوست --> repost
سيتيزن --> Citizen
فيينال --> Final
بماركر --> b Marker
بلايند --> Blind
بروجرس --> Progress
نيتريك --> nitric
بريزون --> Prison
يونيتد --> United
نتوورك --> network
بنيفيت --> Benefit
ستاتيك --> static
ليدينج --> Leading
نيجتيف --> negative
اسبيدر --> spider
دسبنسر --> Dispenser
هارتلس --> Heartless
واكسنج --> Waxing
ريسيست --> resist
ڤيولين --> Violin
برميوم --> Premium
مونولج --> monologue
جولدين --> golden
بورينج --> Boring
اوكسيد --> oxide
راديوم --> radium
سبورتف --> Sportive
ايتينج --> Eating
ستوريي --> story
ارتيست --> Artist
ديجيتل --> digital
ريتينج --> rating
سيرفنج --> surffing
انيواي --> anyway
الاسيد --> El acid
ربيورت --> report
فوريست --> Forest
ميكينج --> making
سابميت --> Submit
بريسنج --> Piercing
هيبريد --> Hybrid
هابننج --> happening
بولستر --> polyester
اسيمنت --> Assigment
أيروني --> Irony
سيفنتي --> Seventy
تالينت --> Talent
بسيرفر --> b server
سابيدر --> spider
اونيون --> Onion
رسيفير --> receiver
ديليفر --> Deliver
دينتكس --> Dentex
تيستتي --> tasty
اوفسيت --> Offset
نييكست --> next
بيسايد --> Beside
بسبريد --> b spread
چيرمان --> German
ريالتي --> Realty
فلورست --> Florist
سيرفيس --> service
آرتيست --> Artist
سينكنج --> Thinking
جينسيس --> Genesis
سبيكنج --> Spiking
تكنكلى --> Technically
راينبو --> Rainbow
هونيست --> honest
ديفنسف --> Defensive
موديست --> MODEST
ووركنج --> working
فريدوم --> freedom
ريبوتر --> Reporter
أوتينج --> outing
آيلاند --> Island
استووب --> stop
توبليس --> Topless
لوونلي --> lonely
مادنيس --> Madness
ايديتت --> edit
ديبرسد --> depressed
فيتينج --> Fitting
تمبليت --> Templet
بريمير --> Premier
إنديكس --> Index
هيليكس --> Helix
أكسيوم --> Axiom
مورننج --> Morning
سااونا --> sauna
هاكينج --> Hacking
سترونق --> strong
