درايف --> drive
ادديد --> Added
فولتج --> voltage
إستوب --> stop
ليمتد --> Limited
لوكنج --> looking
سيلفف --> Self
جولدن --> golden
انجوي --> enjoy
سادنس --> Sadness
أوديو --> audio
سنووز --> snooze
ريفيو --> review
ميسنج --> missing
ريتيد --> rated
ايدجي --> edgy
آيرون --> Iron
دريسر --> Dresser
فولدر --> folder
تايمر --> timer
جيفتد --> gifted
فوودد --> Food
اوكسي --> oxy
سادلي --> sadly
برايم --> Prime
رياكت --> React
سمايل --> smile
سيينج --> Saying
إديوت --> Idiot
جيلتي --> Guilty
ماساج --> massage
سيرفر --> Server
سبانك --> spank
سليبب --> sleep
ستاند --> stand
دايلى --> Daily
برايد --> Pride
سالتد --> Salted
تريبل --> Triple
تايجر --> tiger
جيتار --> guitar
سويير --> swear
أيديت --> Edit
فريدم --> freedom
مووود --> Mood
ساوند --> sound
نيفرر --> never
أوردر --> order
نيڤير --> Never
تيستي --> Tasty
فاملي --> family
ريمكس --> remix
بلانر --> planner
ليفيل --> Level
ويدنج --> wedding
بلوكر --> blocker
جييرل --> girl
نورمل --> normal
ميمبر --> member
جيرلي --> Girly
سآوند --> sound
ديڤيل --> Devil
بالاس --> Palace
فرايد --> Fried
بيينج --> being
ترافل --> travel
دانسر --> Dancer
سلايس --> slice
وركنج --> working
مونكي --> Monkey
مولتن --> Molten
لوكال --> local
رايدر --> Rider
آنجري --> Angry
فتنيس --> fitness
جوينج --> Going
بالنس --> Balance
هابيى --> happy
سوررى --> sorry
بريفت --> private
بيليف --> Believe
داييت --> Diet
بيوتي --> beauty
اوزون --> ozone
ديدنت --> didn't
نتريت --> nitrite
رينبو --> rainbow
سييكر --> Seeker
دايري --> Diary
باكنج --> Baking
هابيي --> happy
آليرت --> Alert
سولار --> solar
كويين --> Queen
كيننج --> kenning
ريسيف --> Receive
مومنت --> moment
استوب --> stop
ماجور --> major
فلكيس --> Flex
فروتس --> fruits
فيلنج --> Feeling
ميرور --> Mirror
أنجري --> Angry
أوزون --> ozone
لاتكس --> latex
إيديت --> Edit
ميسلف --> Myself
ريلكس --> Relax
تااسك --> task
بريود --> period
تيكست --> text
سبيكر --> speaker
ويكند --> weekend
هاندد --> handed
وورلد --> world
فيتنس --> Fitness
ديلير --> Dealer
سوييت --> sweet
لاينر --> Liner
تيرند --> trend
ميتنج --> meeting
سيمبل --> simple
سيلنت --> Silent
ريسكى --> Risky
ريسكي --> Risky
سيتنج --> Setting
كيلير --> Killer
ميتال --> metal
لونلي --> lonely
اوبين --> open
فلينج --> feeling
ستايل --> style
فريست --> first
سيجنل --> Signal
ميست --> mist
هوكي --> hockey
تاان --> tan
سستر --> Sister
ديلر --> Dealer
نيون --> neon
ميتل --> Metal
زووم --> Zoom
