الأبنورمال --> Abnormal
الجالاكسيز --> Galaxy
هارتبريكنج --> Heartbreaking
البلاكبيري --> Blackberry
ميجابارسيك --> Megaparsec
بيرفورمانس --> Performance
اادرينالين --> adrenaline
بالأناتومي --> Anatomy
البروستانت --> Protestant
بروبيجاندا --> propaganda
هيبوكلوريت --> hypochlorite
ترانسفورمر --> transformer
بالاندرويد --> Android
اوتوماتيكى --> automatic
اوتومااتيك --> automatic
البيوتيفول --> Beautiful
موديرااتور --> moderator
أستراتيجين --> strategic
المونوجرام --> monogram
السوبيريور --> Superior
فيلهارموني --> Philharmonic
إيكسايتينج --> Exciting
ديفولبمينت --> development
استراتيجيه --> strategy
ڨيجيتيريان --> Vegetarian
ريجيستريشن --> Registry
كرياتيفيتي --> Creativity
هيدرولوجيا --> hydrology
تيستيسترون --> Testosterone
ميلانكوليا --> melancholia
اوتستاندنج --> Outstanding
بروبوغاندا --> propaganda
بروليتاريا --> proletariat
ابراكدابرا --> abracadabra
الفيمينيسم --> feminism
التراجيديه --> Tragedy
سيكشوالايز --> Sexualize
تيرميناتور --> terminator
بروباغاندا --> propaganda
أستراتيجيت --> strategy
انداستريال --> Industrial
هيدروجينية --> hydrogen
ديبلوماسية --> Diplomacy
يونيفيرستي --> University
اسبيشاليست --> Specialist
الماريونيت --> marionette
انترستيلار --> Interstellar
إستراتيجية --> strategy
ايمبورتانت --> important
كونفيرسيشن --> Conversation
اافورماتيف --> Afformative
ديبارتمينت --> Department
اوفيردرايف --> Overdrive
الاوتومبيل --> Automobile
الديودرانت --> deodorant
تايبوجرافي --> typography
الماركيتنج --> Marketing
اوفرسايزيد --> Oversized
الابنورمال --> Abnormal
الأوتومبيل --> Automobile
ايديولوجيا --> ideology
هيدروجينيه --> hydrogenic
دبولوماسية --> Diplomacy
هيبوثلاموس --> Hypothalamus
بارانورمال --> Paranormal
الفليرتينج --> flirting
كونتيننتال --> Continental
البلاكبورد --> Blackboard
الهيدروجين --> hydrogen
ابستمولوجي --> epistemology
اناليتيكال --> Analytical
أبسوليوتلي --> Absolutely
استراتيجية --> strategic
جراديويتيد --> Graduated
الميترولجي --> metrology
اندودونتست --> Endodontist
كاتابوليزم --> Catabolism
بيوكيمستري --> Biochemistry
ماينتينانس --> maintenance
بنوستالچيا --> Nostalgia
يونيفيرستى --> University
بوليتيكالي --> politically
انثربولوجي --> anthropology
سايتوبلازم --> cytoplasm
بروجستيرون --> progesterone
كيرياتيفتي --> creativity
ديڤيلوبمنت --> Development
هيدرولوجية --> hydrologic
مونولوجيست --> monologist
أوديتوريوم --> Auditorium
ديسجاستينج --> Disgusting
الماتيريال --> Material
الاونجوينج --> Ongoing
اندبيندينت --> Independent
أستراتيجيه --> strategy
دبلوماسيةة --> diplomacy
ادرينالينى --> Adrenaline
ابسليوتيلي --> Absolutely
سوبرفايزور --> Supervisor
نوستولوجيا --> Nostology
ترانسليتور --> Translator
لدبلوماسية --> for diplomacy
كرياتيڤيتي --> Creativity
تستيستيرون --> testosterone
البريكفاست --> El breakfast
إستراتيجيه --> strategy
البنسيللين --> El penicillin
الأوكسيجين --> Oxygen
فورمالدهيد --> formaldehyde
استيراتيجي --> strategic
الجيولوجيه --> El geology
الميديسنال --> El Medicinal
الادرنالين --> El adrenaline
المينتالتي --> El mentality
هيدروكربون --> hydrocarbon
بورليتاريا --> proletariat
ايكونوميست --> Economist
الجلوتينين --> El glutenin
مينيماليزم --> Minimalism
إينسبايرنج --> Inspiring
هيماتولوجى --> hematology
الترايدينت --> El Trident
التيليجرام --> El Telegram
اوتوماتيتش --> automatic
الهيستامين --> El histamine
يونيفرسيتى --> University
الناتيفيتي --> EL Nativity
النيوترينو --> El neutrino
البروتامين --> El Protamine
الهامسترنج --> El hamstring
الجيولوجيا --> El geology
بالتسونامي --> b El tsunami
انجينيرينج --> Engineering
فولكولورية --> Folkloric
انتيليجينس --> intelligence
البلاتفورم --> El platform
ديموجرافية --> demographic
كونسالتينج --> Consulting
السوبرهيرو --> El superhero
الفاميلياا --> El Familia
نيورلوجيست --> Neurologist
فليكسبيلتي --> Flexibility
فيجيتييرين --> Vegetarian
