ماجنيفيسنت --> Magnificent
فور ريممبر --> For Remember
وجينيريتور --> W Generator
البوتستراب --> El bootstrap
الستاندارد --> El Standard
انورمالايز --> A Normalize
اكستراكتيد --> extracted
الفورميولا --> El Formula
تاكسيميتير --> taximeter
اللوياليتي --> El Loyalty
البولونيوم --> El polonium
ابسوليوتلى --> Absolutely
سوو سووييت --> soSweet
الديستروير --> El Destroyer
الموبيليتي --> El Mobility
الباي بولر --> El bi Polar
انسكيوريتي --> Insecurity
الفيمينيست --> feminist
التيرمينال --> El terminal
التوكسسيتي --> El toxicity
انثروبولجي --> anthropology
الجرمانيوم --> El Germanium
أناليتيكال --> analytical
الاوكسيجين --> El oxygen
بورنوجرافي --> Pornography
وبيدياتريك --> W Pediatric
انتيبايوتك --> Antibiotic
البريداتور --> El Predator
الأبارتهيد --> El Apartheid
الاى لاينر --> El eyeliner
البوتاسيوم --> El potassium
يونيفرساال --> Universal
الهيكسوجين --> El hexogen
تيستوسترون --> testosterone
سوبيريورتي --> Superiority
ديسأبوينتد --> Disappointed
يونيفيرسال --> Universal
وفيسيولوجي --> W Physiology
ترانزليتور --> Translator
الموديلينج --> El Modeling
الماركتينج --> El Marketing
كينسيولوجي --> Kinesiology
التراينينج --> El training
بنوستالجيا --> b Nostalgia
هرت بروكين --> Heart Broken
الفيرتشوال --> El virtual
بكتريولوجي --> bacteriology
اليورانيوم --> El uranium
لوكينج فور --> looking for
بيكاربونات --> bicarbonate
البايولوجي --> El Biology
بروفيشينال --> Professional
سبيكتايتور --> Spectator
كومباراتيف --> Comparative
كومبراتيف --> Comparative
نيكولودين --> Nickelodeon
التريتيوم --> tritium
الباركينج --> parking
البوكسينج --> boxing
كونفيرميد --> Confirmed
ابسلولتلي --> Absolutely
راديولوجي --> Radiology
كماركتينج --> Marketing
استيرلينج --> sterling
المومينتم --> Momentum
ترانسفورم --> transform
الجاليوري --> Gallery
هيستامينك --> histamine
الترينينج --> training
فينانسييل --> Financial
ايدولوجية --> ideology
الموديلنج --> Modeling
مونولوجست --> monologist
سميولاتور --> Simulator
البانورما --> panorama
البارافين --> paraffin
ترانسيفير --> transfer
التورتيلا --> tortilla
برولاكتين --> prolactin
بروباجندة --> Propaganda
مينتاليتي --> mentality
البريميوم --> Premium
داينامايت --> dynamite
ريلايتابل --> relatable
اوريجناال --> original
جينيريتور --> Generator
راندومنيس --> Randomness
هيدروكسيل --> hydroxyl
أستراتجية --> strategic
بوميجرانت --> pomegranate
راديولوجى --> radiology
بريفورمنس --> performance
ريزيستانس --> Resistance
تالانتليس --> talentless
اينفينيتي --> Infinity
الموستانج --> mustang
بروتوكولي --> protocol
نوستليجيا --> Nostalgia
الكاراتيه --> karate
ماناجمينت --> management
بيرسونالي --> Personally
ساسبينديد --> suspended
اوريچينال --> original
الريستينج --> resting
سينجيولير --> Cingular
ميديسينال --> Medicinal
البريكينج --> breaking
كونتنينتل --> Continental
بيدياتريك --> Pediatric
الترامواي --> tramway
امفيتامين --> amphetamine
هيستولوجي --> histology
بيرسونالى --> Personally
ترمنولوچي --> Terminology
دراماتيكى --> dramatic
فرابتشينو --> Frappuccino
سترونشيوم --> strontium
المونتاجي --> montage
ستيريوتيب --> Stereotype
ماركتنينج --> Marketing
رومانسيةة --> romance
كونفيرتور --> Convertor
إستراتيجي --> strategic
جورناليزم --> Journalism
فالينتاين --> Valentine
ديماجوجية --> demagoguery
ديستراكتد --> distracted
الفريندلي --> Friendly
ابثولوتلي --> Absolutely
دياجنوستك --> Diagnostic
ديكتاتورا --> dictator
ترمنولوجى --> Terminology
البوردينج --> boarding
سيترونيلا --> citronella
المومنيوم --> aluminum
انترسبتور --> Interceptor
إندبيندنت --> Independent
وماستربيس --> Masterpiece
الهولدينج --> holding
تراڤيلينج --> Traveling
انديبنديت --> Independent
فايبريتور --> Vibrator
ايدينتيتي --> Identity
