رومانتيكي --> romantic
ميترولوجي --> metrology
بهستيرياآ --> hysteria
الومينيوم --> aluminum
سيجماتيزم --> sigmatism
هايبومنيا --> Hypomania
النيتوورك --> Network
نيكيلودين --> Nickelodeon
ماريونييت --> marionette
جورناليست --> Journalist
بروبابلتى --> Probability
سيــناريو --> scenario
الهاندباج --> handbag
كوميتمينت --> Commitment
كاردهولدر --> Cardholder
ڤيسيولوجي --> physiology
البروجريس --> Progress
ماركيتينج --> Marketing
استجماتزم --> astigmatism
لينجوستيك --> Linguistic
تريليونية --> trillion
الريبورتر --> reporter
تيمبرلاند --> Timberland
اوتونوميك --> Autonomic
سالمونيلا --> salmonella
انتيبيوتك --> Antibiotic
دراماتورج --> Dramaturgy
المايسترو --> maestro
ميلليجرام --> milligram
الفولكلور --> folklore
كونفيرتبل --> Convertible
فانتاسايز --> fantasy
ابسولوتلى --> Absolutely
تيمبوراري --> Temporary
أيدولوجية --> ideology
نوستالجيك --> Nostalgic
اكسبلورير --> explorer
بروجيكتور --> projector
فورميدابل --> formidable
هيدوجينية --> hydrogenic
تاكسونومى --> Taxonomy
دبلوماسيه --> diplomatic
البيبولار --> bipolar
مترولوجيا --> metrology
ستابيليتي --> Stability
الإتيتيود --> Altitude
بيرفوريشن --> Perforation
لوكوموتيف --> Locomotive
هامسترينج --> hamstring
الاسبيرين --> aspirin
بروغباندا --> propaganda
سيكس باكس --> six-pack
رومانتكيه --> romantic
ايكسترييم --> Extreme
بروتستانت --> Protestant
سيتوبلازم --> cytoplasm
تراجيدااي --> Tragedy
أنجينيرنج --> Engineering
اندرستاند --> Understand
كومبليمنت --> Complement
الميترالي --> mitral
جينييراال --> General
الالباستر --> alabaster
ريبورتاجا --> Reportage
انتارتيكا --> Antarctica
أيديولوجي --> ideological
دايجيستيف --> Digestive
سيليبريشن --> Celebration
كافيتيريا --> cafeteria
نيتروجيين --> nitrogen
اوريجينال --> original
ديبارتمنت --> Department
ريقاردليس --> Regardless
جرافولوجي --> graphology
بريزيدينت --> President
سرروندينج --> Surrounding
بروتوكولى --> protocol
اوفسبرينج --> Offspring
رومانتيكى --> romantic
انجريدينت --> Ingredient
بوستيريور --> posterior
ريجاردينج --> Regarding
بروتيكتور --> Protector
مورتاليتي --> Mortality
بريسيبتور --> Preceptor
ابسلوتللي --> Absolutely
نوستالچيا --> Nostalgia
داونستريم --> Downstream
إمبروبابل --> improbable
إيمبوسيبل --> Impossible
ديليفرااي --> Delivery
بانتومايم --> pantomime
اندستريال --> Industrial
ابسيولتلي --> Absolutely
استراتيجي --> Strategy
استاتيكال --> statical
نوستولوجي --> Nostology
ابوكاليبس --> Apocalypse
اندرجروند --> Underground
مارجرايتا --> Margarita
السوفييتي --> soviet
نورماليزو --> normalize
السيناريو --> El Scenario
اكسبيرمنت --> Experiment
ستريوتايب --> Stereotype
تاكسونومي --> Taxonomy
الاستوديو --> El studio
ااسيمينار --> Seminar
بلاتينيوم --> Platinum
اندبيندنت --> Independent
إيديولوجي --> ideological
الهاندبوك --> El handbook
البايوتين --> El biotin
ساتيسفايد --> Satisfied
اناكونداا --> anaconda
للكاراتية --> L Karate
البيرسينج --> El piercing
ميلودراما --> melodrama
باكتيريال --> bacterial
مانجيريال --> managerial
ماليجنانت --> Malignant
ابسلوتليي --> Absolutely
مونومنتال --> Monumental
نيكلوديان --> Nickelodeon
لجيولوجية --> geology
الفيستفال --> El Festival
نيتروجينى --> Nitrogenous
جيمناستيك --> Gymnastic
ديستيناشن --> Destination
الهاندريل --> Handrail
اكسبينسيف --> Expensive
بلايتنيوم --> Platinum
بروفيسوره --> Professor
اوبيريتور --> operator
ديموجرافي --> demographic
لستاندارد --> Standard
ابسولوتلي --> Absolutely
السبينينج --> Spinning
ببيولوجيا --> b biology
الفلامنجو --> El flamingo
فينومينون --> phenomenon
ترانزستور --> transistor
مينتاليست --> Mentalist
