دراماتيكا --> dramatic
اوريانتال --> Oriental
هيستولوجى --> histology
ستيجماتزم --> stigmatism
بروبجاندا --> propaganda
إستراتجية --> strategic
چينيراتور --> GENERATOR
الجينيرال --> El General
يونيفرسال --> Universal
ميلليمترا --> millimeter
الميسترال --> El Mistral
ماچييستير --> Master
البرونزيه --> El Bronze
هيدروجيني --> hydrogenic
كواليفييد --> Qualified
نوستاليجا --> Nostalgia
الهاندسوم --> El Handsome
إلاستوديو --> El studio
ديهيدراشن --> dehydration
اكسبيرينس --> Experience
اسراتيجيا --> strategy
هيموفيليا --> hemophilia
امباسادور --> Ambassador
بيووتيفول --> Beautiful
بسكيولوجي --> Psychology
إلسيناريو --> El scenario
الوريكينج --> El working
يونفيرسال --> Universal
ديستينيشن --> Destination
رياليستيك --> Realistic
البابريكا --> paprika
النيوترون --> El neutron
أسترايجية --> strategy
بوتينشيال --> Potential
ديفينيتلي --> Definitely
الريميندر --> El reminder
البايسيبس --> El biceps
دراماتيكي --> dramatic
الفلكلوري --> El folklore
ميتابولزم --> Metabolism
وهيستيريا --> W hysteria
كونسرتيوم --> Consortium
امبورتانت --> Important
إنديبندنت --> Independent
بريكوميند --> b recommend
هيدروكسيد --> hydroxide
الهالوجين --> El halogen
إكسبيرينس --> Experience
ميكروجرام --> microgram
وبانورامي --> W panoramic
بريفاينال --> Prefinal
الاسبستوس --> El asbestos
أيديلوجية --> ideological
كاباسيتيف --> Capacitive
دي ليڨيري --> Delivery
النيجاتيف --> El negative
رومانتيكا --> romantic
ريسبونسيف --> responsive
بانوراميا --> panoramic
الادميرال --> El Admiral
هيدروجنيه --> hydrogen
مونودراما --> monodrama
مانيجمينت --> management
اينستيتوت --> Institute
اورجانيزر --> Organizer
انديبندنت --> Independent
بفولتميتر --> b voltmeter
الديفيندر --> El Defender
بوليتيكال --> political
ريلاكساشن --> Relaxation
كونفيدانت --> Confidant
إنفيستمنت --> Investment
ميلودرامي --> melodramatic
نورمالايز --> normalize
يونييرسال --> Universal
الدريسينج --> El Dressing
بريلليانت --> Brilliant
ديفلوبمنت --> Development
اورديناري --> ordinary
الهوموورك --> El Homework
روماتيويد --> rheumatoid
سيتوبلاسم --> cytoplasm
المونوتون --> El monotone
انفيستمنت --> investment
انتيفيروس --> Antivirus
السينسوري --> El Sensory
الووركينج --> El working
سبستتيوشن --> Substation
كولوستومي --> colostomy
الفوندانت --> El fondant
بوليتكالي --> politically
ريلاكسيشن --> Relaxation
انالتيكال --> Analytical
ريكويرمنت --> Requirement
الدياجرام --> El Diagram
ديموكراسي --> democracy
تيوتوريال --> Tutorial
بورنجرافي --> pornography
الديجيتال --> El digital
بوزيترونى --> Positron
السلينيوم --> El selenium
البوسيتيف --> El Positive
اكستيرنال --> external
يونيفوررم --> Uniform
كونتننتال --> Continental
ادرينالين --> adrenaline
ماستربييس --> Masterpiece
الترانسفر --> El Transfer
أوريچينال --> original
بيروكسايد --> peroxide
الاسيمبلي --> El assembly
كوبي بيست --> copy paste
بيرفورمنس --> Performance
السكيلتال --> El Skeletal
أنيفرساري --> anniversary
الريسيفير --> El receiver
ريفوليوشن --> Revolution
اناسثيسيا --> anaesthesia
الامونيوم --> El ammonium
الأمونيوم --> El ammonium
جينيراتور --> Generator
نيجاتيفتي --> Negativity
الالمينوم --> El aluminum
اكستريملي --> Extremely
ديستنايشن --> Destination
أوتوموتيف --> Automotive
ماغنيسيوم --> Magnesium
البوبولار --> El popular
تيبوجرافي --> typography
السامبلنج --> El sampling
ريلااااكس --> Relax
ماليفسينت --> Maleficent
بروفورمنس --> performance
هايدرازين --> hydrazine
فيسيولوجي --> physiology
السيمبلكس --> El simplex
سيسيولوجي --> sociology
صبلينجوال --> Sublingual
اللاندينج --> El Landing
سيمبوزيوم --> symposium
ثيرموستات --> thermostat
ببارانويا --> b paranoia
الريسبونس --> El response
