ماينوريتي --> Minority
ريستوراشن --> Restoration
راديولوچي --> radiology
ديوديرانت --> deodorant
مينتينانس --> maintenance
بيكربونات --> bicarbonate
ليورانيوم --> uranium
هيموفوبيا --> hemophobia
واتوموتيف --> W Automotive
نوستالجيا --> Nostalgia
فيجيتريان --> Vegetarian
ترانسلاشن --> Translation
ريسوليوشن --> Resolution
الريموتلي --> El remotely
سبيرتشوال --> Spiritual
مايكولوجي --> Mycology
لوكواليتي --> Locality
ستراندينج --> Stranding
وابنورمال --> W Abnormal
الومونيوم --> aluminium
نيورولوجى --> Neurology
دبلوماتيك --> Diplomatic
جست سيينج --> Just Saying
الفريزينج --> El Freezing
الكينجدوم --> El Kingdom
الكى بورد --> El key board
سكيت بورد --> skate board
الداركنيس --> El Darkness
ابسيلوتلي --> Absolutely
انسومونيا --> Insomnia
المانيفست --> El manifest
الريبلااي --> El reply
التنجستين --> El tungsten
ديفولبمنت --> development
كونفيدينس --> Confidence
الاسبرينت --> El Sprint
ديهيدريشن --> dehydration
الاستاتوس --> El Status
فينانشيال --> Financial
الريستارت --> El restart
الانيمياا --> El anemia
الريتينول --> El retinol
الفيمينست --> El Feminist
أونكولوجي --> Oncology
سبيشاليست --> Specialist
مينتاليتى --> mentality
كومبليتلي --> Completely
كريتيفيتي --> Creativity
ريوماتيزم --> rheumatism
البلتفورم --> El platform
باتريوتيك --> Patriotic
الماكسيمم --> El Maximum
موديريتور --> moderator
الليبستيك --> El Lipstick
باراناويا --> Paranoia
نيورولوجي --> Neurology
البيلدينج --> El building
ساتسفاينج --> Satisfying
ديسجاستنج --> Disgusting
ناتشورالل --> Natural
الترومبون --> El trombone
الميمورري --> El Memory
ديفالويشن --> Devaluation
الفينترال --> El ventral
هيومانيست --> humanist
الريتاردد --> El Retarded
برسونالتي --> Personality
برفورمانس --> Performance
بيوتيفوول --> Beautiful
أدرينالين --> adrenaline
وريليتابل --> W relatable
الهابييست --> El Happiest
تنورماليز --> T normalize
الألومينا --> El Alumina
ينورماليز --> E Normalize
المينيموم --> El Minimum
جراديواتد --> Graduated
السبورتيج --> El Sporting
بوزتيفيتي --> positivity
سكرينبلاي --> Screenplay
كرياتيفتي --> Creativity
ريممبر مي --> Remember me
اي ريممبر --> I Remember
تو ريممبر --> To Remember
اسبورتينج --> sporting
المموريال --> El Memorial
دياجنوزيس --> diagnoses
الساليفري --> El salivary
استايليست --> stylist
انليميتيد --> Unlimited
كيب جوينج --> Keep Going
سباركلينج --> Sparkling
الهومينيد --> El hominid
انوريكسيا --> Anorexia
الدياموند --> El Diamond
تستستيرون --> testosterone
فانتاستيك --> Fantastic
سيكيوريتي --> security
كوارانتين --> quarantine
ديجراديشن --> Degradation
الريونيون --> El reunion
إندستريال --> Industrial
السيندروم --> El Syndrome
توكسيسيتي --> Toxicity
ألبنتاجون --> El Pentagon
الهيدرجين --> El hydrogen
وماتيريال --> W Material
تروماتايز --> Traumatize
ماجنيفسنت --> Magnificent
المورنينج --> El Morning
براجماتكس --> pragmatics
ريكوردينج --> Recording
ايمبوسيبل --> Impossible
بلوتينيوم --> plutonium
لوجيستيكس --> Logistics
الباراديس --> El Paradise
ريجاردليس --> Regardless
برجستيرون --> progesterone
مورفولوجي --> morphology
بريستتيشن --> Prestation
مونوفوبيا --> monophobia
اونكولوجي --> Oncology
الفيمنيست --> El feminist
ديسبوزابل --> Disposable
ابسلوتيلي --> Absolutely
الديابيتس --> El Diabetes
ابسلويتلي --> Absolutely
فيستيفتال --> Festival
اللوكيميا --> El leukemia
الستاندرد --> El Standard
ترافيلينج --> Traveling
تراديشنال --> traditional
بارانوياا --> Paranoia
انسبيرينج --> Inspiring
اوڤ ميسلف --> of Myself
لوف ميسلف --> Love Myself
انتيجريتي --> Integrity
الترولينج --> El trolling
الرياليتي --> El Reality
اوردينارى --> ordinary
ترانسليشن --> Translation
يونيفرستي --> University
الأناتومي --> El Anatomy
