مجنتومتري --> magnetometric
دايناميكس --> Dynamics
كومبلمينت --> Complement
ايجنورانس --> ignorance
ريتارديشن --> Retardation
الفرونتنج --> El fronting
سيستماتيك --> Systematic
انفلوينسر --> Influencer
استيودينت --> student
اينفستمنت --> investment
سوسيولوجي --> Sociology
بروكزيمال --> Proximal
سيرفايفور --> survivor
الفورمولا --> El Formula
جيجانتيزم --> Gigantism
بيرفورمنص --> performance
نوستولجيا --> Nostalgia
الكيندنيس --> El Kindness
ديڤلوبمنت --> development
أيدروكسيد --> hydroxide
اوريحينال --> original
البيرسونا --> El Persona
باكجراوند --> Background
الستوكينج --> El stocking
جيروسكوبي --> gyroscopic
بلوتونيوم --> plutonium
الاتروبين --> El atropine
بالراديوم --> b El radium
أوتوموتور --> automotor
الواكسينج --> El Waxing
تيكنولوجي --> technology
كونتينتال --> Continental
فريست لوك --> first look
نيجاتيفتى --> Negativity
رسبيرتوري --> Respiratory
نيفرلاند --> Neverland
سيتولوجي --> Cytology
ديفينتلي --> Definitely
اروماتيك --> Aromatic
الهيبريد --> Hybrid
جينراتور --> Generator
بوتيفوول --> Beautiful
ووندرينج --> Wondering
ستريوتيب --> Stereotype
السنتروم --> centrum
الجوريذم --> Algorithm
المسترال --> Mistral
مالمليون --> million
السيمنار --> Seminar
بيوتيريك --> butyric
راندوملي --> Randomly
كفانتازي --> Fantasy
رومنسيني --> Romance
دراماتيك --> dramatic
بروديوسر --> Producer
ديسسكارد --> Discard
السموكنج --> smoking
نيكتارين --> nectarine
ليبراليا --> liberal
سبيسياال --> special
اوكرديون --> accordion
أبارتهيد --> apartheid
هستولوجي --> histology
باليرينا --> ballerina
بوتينشال --> Potential
سااموراي --> samurai
فاميليار --> familiar
إيفرجرين --> evergreen
استررونج --> strong
الفيكسيد --> Fixed
اتلانتيك --> Atlantic
هيدروچين --> hydrogen
ديكتاتور --> Dictator
بريليانت --> Brilliant
بورسيلين --> Porcelain
اسيمبليي --> Assembly
مونتاجية --> montage
استرونجج --> strong
ايفينينج --> Evening
التمبليت --> Templet
ستييرينج --> Steering
وراسبيري --> raspberry
بروفيسور --> Professor
كونتراست --> Contrast
نوميركال --> numerical
انسوليين --> Insulin
جورجويوس --> Gorgeous
ميدسينال --> medicinal
رومانسيه --> romance
انفورميد --> Informed
سوبرماان --> Superman
أوريجنال --> Original
باربيكان --> Barbican
رادياتير --> radiator
بالارينا --> ballerina
البولينج --> bowling
سمبوزيوم --> Symposium
كريتيريا --> criteria
الادفانس --> Advance
وبيرفيوم --> Perfume
انانيموس --> Anonymous
ايساغوجي --> Isagoge   1
اوبتيميز --> Optimize
اسبورتنج --> sporting
كربوناتي --> carbonate
فورميولا --> Formula
بوسيتيفف --> Positive
السستروم --> sistrum
بيتشفورك --> Pitchfork
ترانزيتي --> transit
اندرايدچ --> Underage
برنسيسسه --> Princess
وأناتومي --> Anatomy
ماركتينح --> Marketing
التيفولي --> tivoli
فيمينيسم --> feminism
الترايلر --> trailer
مديسينال --> medicinal
جينيروتر --> Generator
مورنينجز --> Mornings
المينيوم --> aluminum
ستيرلينج --> Sterling
فلكلورية --> folklore
برتفوليو --> portfolio
افترلايف --> Afterlife
بلاكبورد --> blackboard
بايولوجى --> Biology
لوچيستية --> logistic
المتادور --> Matador
بويتيفول --> Beautiful
ترمنلوجي --> Terminology
بورترايت --> Portrait
دياثيرمي --> diathermy
إيكونومي --> Economy
اوتومبيل --> Automobile
ألومنيوم --> Aluminium
ديناميكي --> dynamic
دايجيستف --> Digestive
البريمير --> Premier
استروونج --> strong
فولووينج --> following
بوتستراب --> bootstrap
وندرلاند --> Wonderland
